//當代中文/Book 1/L01-I		
陳月美	Chén Yuèměi	a woman from Vietnam
李明華	Lǐ Mínghuá	a man from Taiwan
王開文	Wáng Kāiwén	a man from the US
你	nǐ	(N) you
來	lái	(V) to come
是	shì	(Vst) to be
小姐	xiǎojiě	(N) Miss, Ms
嗎	ma	(Ptc) sentence final particle
接	jiē	(V) to pick sb up
我們	wǒmen	(N) we, us
我	wǒ	(N) I, me
這	zhè / zhèi	(Det) this
先生	xiānshēng	(N) Mr
好	hǎo	(Vs) fine, well
姓	xìng	(Vst) to be surnamed
叫	jiào	(Vst) to be called, i.e., to have the first name xx
你們	nǐmen	(N) you (plural)
臺灣/台灣	Táiwān	Taiwan
歡迎	huānyíng	welcome
請問	qǐngwèn	May I ask you... Excuse me,…
是的	shìde	yes
謝謝	xièxie	Thank you
不客氣	búkèqì	You're welcome'
你好	nǐ hǎo	How are you? Hello
//當代中文/Book 1/L01-II		
請	qǐng	(V) please
喝	hē	(V) to drink
茶	chá	(N) tea
很	hěn	(Adv) very
好喝	hǎohē	(Vs) (lit. good to drink) to taste good
什麼	shénme	(N) what
人	rén	(N) person, people
喜歡	xǐhuān	(Vst) to like
呢	ne	(Ptc) sentence final particle
他	tā	(N) he, him
不	bù	(Adv) not
哪	nǎ / něi	(Det) which
要	yào	(Vaux) to want to
咖啡	kāfēi	(N) coffee
烏龍茶	Wūlóng chá	Oolong tea
日本	Rìběn	Japan
美國	Měiguó	America
對不起	duìbùqǐ	I'm sorry'
哪國	nǎguó / něi guó	Which country?
//當代中文/Book 1/L02-I		
張怡君	Zhāng Yíjūn	a woman from Taiwan
馬安同	Mǎ Āntóng	a man from the Republic of Honduras
的	de	(Ptc) modification marker
家人	jiārén	(N) family (members)
家	jiā	(N) home, house
漂亮	piàoliàng	(Vs) pretty
房子	fángzi	(N) house
坐	zuò	(Vi) to sit
好	hǎo	(Ptc) OK
有	yǒu	(Vst) to have
多	duō	(Vs-pred) many
照片	zhàopiàn	(N) photo
都	dōu	(Adv) all, both
照相	zhàoxiàng	(V-sep) to take a photo
張	zhāng	(M) measure word for flat objects (e.g., paper, tickets)
好看	hǎokàn	(Vs) good-looking
誰	shéi	(N) who
姐姐	jiějie	(N) older sister
妹妹	mèimei	(N) younger sister
爸爸	bàba	(N) dad
媽媽	māma	(N) mom
請進	qǐng jìn	Please come in!
//當代中文/Book 1/L02-II		
田中誠一	Tiánzhōng Chéngyī	a man from Japan
伯母	bómǔ	(N) aunt; here a polite term for a friends' mother regardless of age'
您	nín	(N) you (honorific)
名字	míngzi	(N) name
書	shū	(N) book
哥哥	gēge	(N) older brother
老師	lǎoshī	(N) teacher
看書	kànshū	(V-sep) to read
幾	jǐ	(N) how many
個	ge	(M) general measure word
沒	méi	(Adv) not
兄弟	xiōngdì	(N) brothers
姐妹	jiěmèi	(N) sisters
五	wǔ	(N) five
兩	liǎng	(N) two
//當代中文/Book 1/L03-I		
週末	zhōumò	(N) weekend
聽	tīng	(V) to listen
音樂	yīnyuè	(N) music
運動	yùndòng	(Vi) to exercise
打	dǎ	(V) to play (ball games)
網球	wǎngqiú	(N) tennis
棒球	bàngqiú	(N) baseball
和	hàn	(Conj) and, as well as
游泳	yóuyǒng	(V-sep) to swim
常	cháng	(Adv) often
籃球	lánqiú	(N) basketball
也	yě	(Adv) also
踢	tī	(V) to kick
足球	zúqiú	(N) soccer
覺得	juéde	(Vst) to feel, to think
好玩	hǎowán	(Vs) Interesting, fun
明天	míngtiān	(N) tomorrow
早上	zǎoshàng	(N) morning
去	qù	(V) to go
怎麼樣	zěnmeyàng	(Vs) How about it? How does that sound? What do you think?
啊	a	(Ptc) sentence-final particle
做什麼	zuò shénme	do what
好啊	hǎo a	OK
//當代中文/Book 1/L03-II		
白如玉	Bái Rúyù	a woman from the US
今天	jīntiān	(N) today
晚上	wǎnshàng	(N) evening, night
看	kàn	(V) to see, to watch
電影	diànyǐng	(N) movie
妳	nǐ	(N) you (female)
想	xiǎng	(Vaux) to want, to think
還是	háishì	(Conj) or (used in a question)
吧	ba	(Ptc) sentence-final particle for suggestion
可以	kěyǐ	(Vaux) could (possibility)
學	xué	(V) to learn, to study
中文	Zhōngwén	(N) Chinese language
一起	yìqǐ	(Adv) together
吃	chī	(V) to eat
晚飯	wǎnfàn	(N) dinner
菜	cài	(N) cuisine
越南	Yuènán	Vietnam
好不好	hǎo bù hǎo	How about...? How does that sound?
//當代中文/Book 1/L04-I		
一共	yígòng	(Adv) altogether
多少	duōshǎo	(N) how much, how many
錢	qián	(N) money
老闆	lǎobǎn	(N) store-owner, boss
買	mǎi	(V) to buy
杯	bēi	(M) cup
熱	rè	(Vs) hot
包子	bāozi	(N) steamed buns with meat stuffing filling
要	yào	(V) to want, to need
大	dà	(Vs) large
中	zhōng	(Vs-attr) medium
小	xiǎo	(Vs) small
幫	bāng	(Prep) for
微波	wéibō	(V) to microwave
百	bǎi	(N) hundred
塊	kuài	(M) measure word for Chinese money
好的	hǎode	OK
外帶	wàidài	take out, to go
內用	nèiyòng	for here
//當代中文/Book 1/L04-II		
支	zhī	(M) measure word for cell phones
新	xīn	(Vs) new
手機	shǒujī	(N) cell phone
太	tài	(Adv) too
舊	jiù	(Vs) old
了	le	(Ptc) sentence-final particle indicating the speaker's sense of certainty'
種	zhǒng	(M) kind, type
能	néng	(Vaux) can, be able to
上網	shàngwǎng	(V-sep) to access the internet, to use the internet
那	nà / nèi	(Det) that
貴	guì	(Vs) expensive
賣	mài	(V) to sell
便宜	piányí	(Vs) cheap, inexpensive
要	yào	(Vst) to take, to require
萬	wàn	(N) ten thousand
千	qiān	thousand
為什麼	wèishénme	why
//當代中文/Book 1/L05-I		
牛肉	niúròu	(N) beef
麵	miàn	(N) noodles
真	zhēn	(Adv) really
好吃	hǎochī	(Vs) delicious
說	shuō	(V) say
少	shǎo	(Vs-pred) few in number
有名	yǒumíng	(Vs) well known, famous
小吃	xiǎochī	(N) light repast, snack
最	zuì	(Adv) most
湯	tāng	(N) soup, broth
這麼	zhème	(Adv) so
知道	zhīdào	(Vst) to know
家	jiā	(M) measure word for restaurants, shops, etc
店	diàn	(N) shop, store
一定	yídìng	(Adv) really must, definitely
點	diǎn	(V) to order (meals)
碗	wǎn	(M) a bowl of
是啊	shì a	That's right'
小籠包	xiǎolóngbāo	xiaolongbao, e.g., small meat and cabbage-filled steamed buns
臭豆腐	chòu dòufǔ	stinky tofu (fermented tofu)
太好了	tài hǎo le	Excellent. Great
//當代中文/Book 1/L05-II		
昨天	zuótiān	(N) yesterday
餐廳	cāntīng	(N) restaurant
可是	kěshì	(Conj) but, however
辣	là	(Vs) hot (spicy)
怕	pà	(Vst) (here) to not like, to fear
所以	suǒyǐ	(Conj) therefore, so
自己	zìjǐ	(N) self
做飯	zuòfàn	(V-sep) to cook
得	de	(Ptc) complement marker
會	huì	(Vaux) to be able to, can
甜點	tiándiǎn	(N) dessert
不錯	búcuò	(Vs) not bad
可以	kěyǐ	(Vaux) could (possibility)
教	jiāo	(V) to teach
到	dào	(Prep) to
有一點	yǒu yì diǎn	a little
不好	bù hǎo	not well
//當代中文/Book 1/L06-I		
他們	tāmen	(N) they (used for people only)
學校	xuéxiào	(N) school
在	zài	(Vst) to be located at
山上	shānshàng	(N) on a mountain, in the mountains
哪裡	nǎlǐ	(N) where
遠	yuǎn	(Vs) far
那裡	nàlǐ	(N) that place, there
風景	fēngjǐng	(N) scenery, landscape
美	měi	(Vs) beautiful
前面	qiánmiàn	(N) front
海	hǎi	(N) ocean
後面	hòumiàn	(N) back
山	shān	(N) mountain
真的	zhēnde	(Adv) really, truly
地方	dìfāng	(N) place
現在	xiànzài	(N) now
附近	fùjìn	(N) vicinity, near
樓下	lóuxià	(N) downstairs
找	zhǎo	(V) to meet, to see
朋友	péngyǒu	(N) friend
上課	shàngkè	(V-sep) to go to class
花蓮	Huālián	name of a city on the eastern coast of Taiwan
聽說	tīngshuō	hear that
//當代中文/Book 1/L06-II		
近	jìn	(Vs) near
方便	fāngbiàn	(Vs) convenient
這裡	zhèlǐ	(N) here, this place
學生	xuéshēng	(N) student
在	zài	(Prep) at
東西	dōngxi	(N) things, stuff
外面	wàimiàn	(N) outside
裡面	lǐmiàn	(N) inside
商店	shāngdiàn	(N) store, shop
吃飯	chīfàn	(V-sep) to have a meal
宿舍	sùshè	(N) dormitory
樓	lóu	(N) a storey, a floor
棟	dòng	(M) measure word for buildings
大樓	dàlóu	(N) a multi-storey building
圖書館	túshūguǎn	(N) library
旁邊	pángbiān	(N) (by the) side, next to
教室	jiàoshì	(N) classroom
游泳池	yóuyǒngchí	(N) swimming pool
//當代中文/Book 1/L07-I		
點	diǎn	(M) o'clock'
KTV		Karaoke
唱歌	chànggē	(V-sep) to sing
分	fēn	(M) minute
見面	jiànmiàn	(V-sep) meet
從	cóng	(Prep) from
中午	zhōngwǔ	(N) noon
得	děi	(Vaux) to have to, must
銀行	yínháng	(N) bank
時候	shíhòu	(N) when
後天	hòutiān	(N) the day after tomorrow
大安	Dà'ān'	Da-an (name of a KTV named after a district in Taipei, where Shida is also located.)
下次	xiàcì	next time
沒問題	méi wèntí	No problem
對了	duìle	by the way
有空	yǒu kòng	to have free time
再見	zàijiàn	goodbye
//當代中文/Book 1/L07-II		
在	zài	(Vs) progressive aspect verb; in the process of doing something
午餐	wǔcān	(N) lunch
剛	gāng	(Adv) just now
下課	xiàkè	(V-sep) to finish class
下午	xiàwǔ	(N) afternoon
半	bàn	(N) half
比賽	bǐsài	(N) game, competition
結束	jiéshù	(Vp) to finish
最近	zuìjìn	(N) recently, lately
忙	máng	(Vs) busy
每	měi	(Det) every, each
天	tiān	(M) Measure word for day
書法	shūfǎ	(N) calligraphy
課	kè	(N) class
開始	kāishǐ	(Vp) to begin, to start
字	zì	(N) character
寫	xiě	(V) to write
可以	kěyǐ	(Vaux) may (permission)
問	wèn	(V) to ask
等一下	děng yíxià	later
有事	yǒu shì	to be busy; to be engaged
有意思	yǒu yìsi	to be interesting, to be fun
//當代中文/Book 1/L08-I		
坐	zuò	(V) to take, to travel by
火車	huǒchē	(N) train
跟	gēn	(Prep) with
玩	wán	(V) to have fun
怎麼	zěnme	(Adv) how
慢	màn	(Vs) slow
鐘頭	zhōngtóu	(N) hour
比較	bǐjiào	(Adv) (comparatively) more
快	kuài	(Vs) fast
車票	chē piào	(N) (train, bus) ticket
非常	fēicháng	(Adv) very
但是	dànshì	(Conj) but, however
又	yòu	(Adv) both… and...
舒服	shūfú	(Vs) comfortable
站	zhàn	(N) station
或是	huòshì	(Conj) or
臺南	Táinán	a city in southwestern Taiwan
高鐵	gāotiě	High Speed Rail (HSR)
網路上	wǎnglù shàng	on the Internet
便利商店	biànlì shāngdiàn	convenience store
//當代中文/Book 1/L08-II		
同學	tóngxué	(N) classmate
參觀	cānguān	(V) to visit (an institution)
古代	gǔdài	(N) ancient times
騎	qí	(V) to ride
機車	jīchē	(N) motorcycle, scooter
載	zài	(V) to give someone a ride (on / in a vehicle, e.g. motorcycle, bicycle or car)
捷運	jiéyùn	(N) Mass Rapid Transit (MRT)
比	bǐ	(Prep) (more...) than
故宮博物院 (故宮)	Gùgōng Bówùyuàn	National Palace Museum
中國	Zhōngguó	China
公共汽車	gōnggòng qìchē	bus
不行	bù xíng	will not do
計程車	jìchéngchē	taxi
差不多	chābùduō	about the same
//當代中文/Book 1/L09-I		
星期 + number	xīngqí	week (day of the week)
回國	huíguó	(V-sep) to return to one's country'
打算	dǎsuàn	(Vaux) to plan to
電視	diànshì	(N) TV
影片	yǐngpiàn	(N) film
旅行	lǚxíng	(Vi) to travel
功課	gōngkè	(N) homework
出去	chūqù	(Vi) to go out
大概	dàgài	(Adv) approximately, about, probably
放假	fàngjià	to have a holiday
下個星期	xiàge xīngqí	next week
有時候	yǒushíhòu	sometimes
多久	duō jiǔ	how long
臺東	Táidōng	name of one of the major cities on the southeastern coast of Taiwan
//當代中文/Book 1/L09-II		
女 + noun	nǚ	girl-, female-
number + 月	yuè	month of a year
number + 號	hào	date, day of a month
帶	dài	(V) to take
她	tā	(N) she, her
還	hái	(Adv) still, additionally
建議	jiànyì	(N) suggestion
夜市	yèshì	(N) night market
應該	yīnggāi	(Vaux) should
逛	guàng	(V) to wander around, to look around
特別	tèbié	(Vs) special
茶館	cháguǎn	(N) tea house
決定	juédìng	(Vp) to decide
要是	yàoshì	(Conj) if
就	jiù	(Adv) then
貓空	Māokōng	name of a must-see place in Taipei to visit for fine tea and scenery
//當代中文/Book 1/L10-I		
水果	shuǐguǒ	(N) fruit
黃色	huángsè	(N) yellow
芒果	mángguǒ	(N) mango
給	gěi	(V) to give
塊	kuài	(M) measure word for pieces of food (e.g., meat, cake)
香	xiāng	(Vs) fragrant
甜	tián	(Vs) sweet (taste)
紅色	hóngsè	(N) red
西瓜	xīguā	(N) watermelon
吧	ba	(Ptc) sentence-final particle for guessing
對	duì	(Vs) correct, right
以前	yǐqián	(N) before
機會	jīhuì	(N) opportunity
請	qǐng	(V) to treat sb to sth
吃吃看	chīchīkàn	to have a taste, try it, taste it
//當代中文/Book 1/L10-II		
拍	pāi	(V) to take (pictures)
笑	xiào	(V) to laugh, to smile
開心	kāixīn	(Vs) happy
穿	chuān	(V) to wear, to put on
衣服	yīfú	(N) clothes
旅館	lǚguǎn	(N) hotel
太太	tàitai	(N) wife
矮	ǎi	(Vs) short (height)
高	gāo	(Vs) tall
弟弟	dìdi	(N) younger brother
乾淨	gānjìng	(Vs) clean
窗戶	chuānghù	(N) window
往	wǎng	(Prep) toward, to
藍色	lánsè	(N) blue
因為	yīnwèi	(Conj) because
住	zhù	(V) to stay
上個月	shàng ge yuè	last month
這些	zhèxiē	these
//當代中文/Book 1/L11-I		
租	zū	(V) to rent
房東	fángdōng	(N) landlord
客廳	kètīng	(N) living room
廚房	chúfáng	(N) kitchen
左邊	zuǒbiān	(N) left (side)
右邊	yòubiān	(N) right (side)
浴室	yùshì	(N) bathroom
超市	chāoshì	(N) supermarket
走路	zǒulù	(V-sep) to walk
分鐘	fēnzhōng	(M) measure word for minutes
就	jiù	(Adv) only, merely
到	dào	(Vp) arrive
間	jiān	(M) measure word for houses, rooms, etc
空	kōng	(Vs) vacant, empty
房間	fángjiān	(N) room
套房	tàofáng	(N) suite
回去	huíqù	(Vi) to go back, to return
想	xiǎng	(V) to think
再	zài	(Adv) and then
電話	diànhuà	(N) telephone
給	gěi	(Prep) to
林	Lín	Chinese last name, common in Taiwan
打電話	dǎ diànhuà	to make a phone call
//當代中文/Book 1/L11-II		
喂	wéi	(Ptc) a particle used in addressing people, especially over the phone
房租	fángzū	(N) rent (for a room or a house)
已經	yǐjīng	(Adv) already
習慣	xíguàn	(Vs) to get settled down, to get used to
問題	wèntí	(N) problem, question
熱水器	rèshuǐqì	(N) water heater
好像	hǎoxiàng	(Adv) to seem to be, to appear to be (often used to take the edge off of a comment)
會	huì	(Vaux) will
等	děng	(V) to wait for
那	nà	(Ptc) then, in that case
裝	zhuāng	(V) to install
不過	búguò	(Conj) however, but
付	fù	(V) to pay
收到	shōudào	to receive
不好意思	bùhǎo yìsi	sorry
沒關係	méi guānxi	Not a problem
有線電視	yǒuxiàn diànshì	cable TV
//當代中文/Book 1/L12-I		
計畫	jìhuà	(V) to plan to
年	nián	(M) measure word for year
久	jiǔ	(Vs) long (time)
時間	shíjiān	(N) time
先	xiān	(Adv) first
念	niàn	(V) to study
大學	dàxué	(N) university
需要	xūyào	(Vst) to need
花	huā	(V) to spend (time or money)
獎學金	jiǎngxuéjīn	(N) scholarship
成績	chéngjī	(N) grades
學費	xuéfèi	(N) tuition
公司	gōngsī	(N) company
替	tì	(Prep) for, on behalf of
希望	xīwàng	(Vst) to hope
以後	yǐhòu	(N) in the future
到	dào	(V) to go/ come to
上班	shàngbān	(V-sep) to go to work
念書	niànshū	(V-sep) to study
累	lèi	(Vs) tired
語言中心	yǔyán zhōngxīn	language center
加油	jiāyóu	keep up the good work
//當代中文/Book 1/L12-II		
工作	gōngzuò	(Vi) to work
去年	qùnián	(N) last year
做	zuò	(V) to do, to engage in
生意	shēngyì	(N) business
以後	yǐhòu	(N) afterwards
好	hǎo	(Vs) easy to
找	zhǎo	(V) to look for
工作	gōngzuò	(N) job, work
這樣	zhè yàng	(N) this kind (of)
國家	guójiā	(N) country
試	shì	(Vi) to try
難	nán	(Vs) hard to, difficult to
那麼	nàme	(Ptc) then
再	zài	(Adv) again
試試看	shìshìkàn	to give it a try, try and see what happens
//當代中文/Book 1/L13-I		
生日	shēngrì	(N) birthday
快樂	kuàilè	(Vs) happy
回來	huílái	(Vi) to come back
啊	a	(Ptc) a particle indicating a realization
怎麼	zěnme	(Adv) How come?
忘(了)	wàngle	(Vpt) to forget
記得	jìde	(Vst) to remember
當然	dāngrán	(Adv) certainly, of course
語言	yǔyán	(N) language
交換	jiāohuàn	(V) to exchange
那麼	nàme	(Adv) so (very)
熱心	rèxīn	(Vs) with enthusiasm
西班牙文	Xībānyá wén	(N) the Spanish language
一樣	yíyàng	(Vs) the same, alike
過	guò	(V) to celebrate
左右	zuǒyòu	(N) approximately
門口	ménkǒu	(N) gate, entrance
西班牙	Xībānyá	Spain
生日快樂	shēngrì kuàilè	Happy Birthday
我就是	wǒ jiù shì	(said of self on the phone) This is s/he speaking
好久不見	hǎojiǔ bújiàn	long time no see
不必客氣	búbì kèqì	No need to stand on formalities, i.e., It's my pleasure '
太客氣	tài kèqì	That's very kind of you'
//當代中文/Book 1/L13-II		
禮物	lǐwù	(N) gift, present
今年	jīnnián	(N) this year
訂	dìng	(V) to order (something in advance)
了	le	(Ptc) verbal particle indicating a completed action
豬腳	zhūjiǎo	(N) pork knuckles
麵線	miànxiàn	(N) extra fine noodles
蛋	dàn	(N) egg
一點	yìdiǎn	(Vs) a little, some
傳統	chuántǒng	(N) tradition, customs
年輕	niánqīng	(Vs) young
蛋糕	dàngāo	(N) cake
對	duì	(Prep) to
祝	zhù	(V) to wish (somebody happiness, good luck, etc.)
哪裡,哪裡	nǎlǐ nǎlǐ	It's my pleasure. Don't mention it.'
大部分	dà bùfèn	most (of), mostly
萬事如意	wànshì rúyì	May everything go your way
心想事成	xīnxiǎng shìchéng	May all your wishes come true
//當代中文/Book 1/L14-I		
天氣	tiānqì	(N) weather
冷	lěng	(Vs) cold
風	fēng	(N) wind
滑雪	huáxuě	(V-sep) to ski
春天	chūntiān	(N) spring (season)
想	xiǎng	(Vst) to miss (someone)
新年	xīnnián	(N) New Year
快	kuài	(Adv) soon
父母	fùmǔ	(N) parents
冬天	dōngtiān	(N) winter (season)
明年	míngnián	(N) next year
秋天	qiūtiān	(N) autumn (season)
紅葉	hóngyè	(N) red maple leaves
只	zhǐ	(Adv) only, merely
玉山	Yùshān	Yu Shan (Mount Jade), tallest mountain in central Taiwan
紐約	Niǔyuē	New York
下雪	xiàxuě	to snow
十二月底	shí'èryuè dǐ'	the end of December
//當代中文/Book 1/L14-II		
雨	yǔ	(N) rain
傘	sǎn	(N) umbrella
颱風	táifēng	(N) typhoon
要	yào	(Adv) will, going to
夏天	xiàtiān	(N) summer (season)
濕	shī	(Vs) wet
討厭	tǎoyàn	(Vs) annoying
新聞	xīnwén	(N) news
更	gèng	(Adv) even (more, less, etc.)
大家	dàjiā	(N) everyone
小心	xiǎoxīn	(Vs) to be careful, to take care
可怕	kěpà	(Vs) scary
停	tíng	(Vp) to stop
下雨	xiàyǔ	to rain
這次	zhè cì	this time
上次	shàng cì	last time
慢走	màn zǒu	Bye. Take care
//當代中文/Book 1/L15-I		
醫生	yīshēng	(N) doctor
一直	yìzhí	(Adv) continuously, all the way
流	liú	(V) to flow
鼻水	bíshuǐ	(N) snot, nasal mucus, a running nose
頭	tóu	(N) head
痛	tòng	(Vs) painful
胃口	wèikǒu	(N) appetite
差	chā	(Vs) poor, bad
喉嚨	hóulóng	(N) throat
發炎	fāyán	(Vp-sep) to be inflamed
生病	shēngbìng	(Vp) to fall ill
發燒	fāshāo	(Vp-sep) to have a fever
感冒	gǎnmào	(Vp) to catch/have a cold
藥	yào	(N) medicine
藥局	yàojú	(N) pharmacy, drug store
拿	ná	(V) to get
把	bǎ	(Ptc) disposal marker
水	shuǐ	(N) water
休息	xiūxí	(Vi) to take a rest
睡覺	shuìjiào	(V-sep) to sleep
早一點	zǎo yìdiǎn	a bit earlier
//當代中文/Book 1/L15-II		
臉色	liǎnsè	(N) a person's "color" (said of the face when healthy or sick, pleased or angry etc.)'
難看	nánkàn	(Vs) not to look good
肚子	dùzi	(N) stomach, abdomen
吐	tù	(V) to throw up, to vomit
幾	jǐ	(N) (a) few
次	cì	(M) measure word for times, occurrences
陪	péi	(V) to go/stay with somebody, to accompany
看病	kànbìng	(V-sep) to see a doctor
健康	jiànkāng	(N) health
保險	bǎoxiǎn	(N) insurance
跟	gēn	(Prep) to
油	yóu	(Vs) oily, greasy
冰	bīng	(Vs) icy
別	bié	(Adv) don't (used in imperatives)'
關心	guānxīn	(Vs) to be concerned about
包	bāo	(M) measure word for bags, packages etc
睡	shuì	(Vi) to sleep
小時	xiǎoshí	(N) hour
怎麼了	zěnme le	What's wrong?'
不用了	búyòng le	It's not necessary'
健康中心	jiànkāng zhōngxīn	health center
回家	huí jiā	go home
最好	zuì hǎo	It would be best.../ (You) should
//當代中文/Book 2/L01-I		
走	zǒu	(Vi) to get to
路人	lùrén	(N) someone; lit. a person on the street
幫忙	bāngmáng	(V-sep) to help
迷路	mílù	(Vp-sep) to be lost, to have lost directions
下	xià	(Det) next
路口	lùkǒu	(N) intersection
段	duàn	(N) section
過	guò	(V) to go past, to cross
第	dì	(Det) used to indicate ordinal numbers
紅綠燈	hónglǜdēng	(N) traffic light
告訴	gàosù	(V) to tell
提款機	tíkuǎnjī	(N) ATM machine
超商	chāo-shāng	(N) convenience store
應該	yīnggāi	(Vaux) should; ought to
郵局	yóujú	(N) post office
提	tí	(V) to withdraw (money)
那邊	nàbiān / nèibiān	(N) over there, yonder
師大 (師範大學)	Shīdà (Shīfàn Dàxué)	NTNU (National Taiwan Normal University)
和平東路	Hépíng Dōng Lù	Heping East Road
往前	wǎng qián	forward, ahead
右轉	yòu zhuǎn	to turn right
聽起來	tīng qǐlái	to sound, sound like
看見	kànjiàn	to see, to have seen
//當代中文/Book 2/L01-II		
下載	xiàzài	(V) to download
地圖	dìtú	(N) map
好用	hǎoyòng	(Vs) easy to use, handy
著	zhe	(Ptc) a particle indicating progression or continuation of action
日用品	rìyòngpǐn	(N) articles of daily use
經過	jīngguò	(V) to go past
巷子	xiàngzi	(N) alley
餓	è	(Vs) hungry
一邊	yìbiān	(Adv) indicates doing two things simultaneously, as, while
發現	fāxiàn	(Vpt) to discover
離	lí	(Prep) (away) from
背包	bēibāo	(N) backpack
正好	zhènghǎo	(Adv) just, happen to
最後	zuìhòu	(Adv) in the end, finally
枝	zhī	(M) measure word for pens
筆	bǐ	(N) pen
本	běn	(M) measure word for books
本子	běnzi	(N) notebook
左轉	zuǒ zhuǎn	to turn left
師大路上	Shīdà Lù shàng	on Shida Road
麵店	miàn diàn	noodle shop
//當代中文/Book 2/L02-I		
還是	háishì	(Adv) should probably, alternatively, had better
早	zǎo	(Vs) Good morning
約	yuē	(V) to invite someone to do something at a specific time
對面	duìmiàn	(N) on the other side of (something), opposite
直接	zhíjiē	(Adv) directly
不必	búbì	(Vaux) no need to, not necessary to
換	huàn	(V) to transfer (transportation)
車站	chēzhàn	(N) bus station, train station
麻煩	máfán	(Vs) troublesome
趕快	gǎnkuài	(Adv) right away; quickly (indicating urgency)
走	zǒu	(Vp) to leave, to bid farewell
班次	bāncì	(N) number of scheduled runs (of trains, flights, boats, buses)
禮拜	lǐbài	(N) week
見	jiàn	(V) to see
電腦展	diànnǎo zhǎn	computer show
世貿展覽館	Shìmào Zhǎnlǎn Guǎn	World Trade Center Exhibition Hall
展覽館	zhǎnlǎn guǎn	exhibition hall
台北	Táiběi	Taipei
2號線	èr hào xiàn	Line 2 (of Taipei MRT)
別急	bié jí	No need to hurry. Take your time
//當代中文/Book 2/L02-II		
飛機	fēijī	(N) airplane
轉機	zhuǎn jī	(V-sep) to transfer (flights)
機場	jīchǎng	(N) airport
巴士	bāshì	(N) bus
市區	shìqū	(N) downtown
下	xià	(V) to get off, alight, disembark
交通	jiāotōng	(N) transportation
便利	biànlì	(Vs) convenient, handy
到處	dàochù	(Adv) everywhere
路線	lùxiàn	(N) route
複雜	fùzá	(Vs) complicated
輕鬆	qīngsōng	(Vs) with ease
東部	dōngbù	(N) eastern part
海邊	hǎibiān	(N) seaside
島	dǎo	(N) island
搭	dā	(V) to take (bus, boat, plane, taxi, etc.)
船	chuán	(N) boat, ship
地	de	(Ptc) adverbial particle
美美	Měiměi	Meimei, name of a girl
法國	Fǎguó	France
歐洲	Ōuzhōu	Europe
悠遊卡	yōuyóukǎ	EasyCard (MRT pass)
綠島	Lǜdǎo	Green Island, to the southeast of the main island
東南邊	dōngnán biān	the southeast side of
好好地	hǎohǎo de	to do something properly
//當代中文/Book 2/L03-I		
進步	jìnbù	(Vp) to make improvement, to progress
早	zǎo	(Vs) early
考試	kǎoshì	(N) a test, examination
準備	zhǔnbèi	(V) to prepare, to get ready
考	kǎo	(V) to take a test
聽寫	tīngxiě	(N) dictation
容易	róngyì	(Vs) easy
小學	xiǎoxué	(N) elementary school
漢字	hànzì	(N) Chinese characters
高中	gāozhōng	(N) senior high school
過	guò	(Ptc) a particle indicating experience
才	cái	(Adv) just, only
說話	shuōhuà	(V-sep) to speak
不夠	bú gòu	(Adv) not quite, not enough
流利	liúlì	(Vs) fluent
雖然	suīrán	(Conj) although
環境	huánjìng	(N) environment, surroundings
同意	tóngyì	(Vst) to agree with
報紙	bàozhǐ	(N) newspapers
麵包	miànbāo	(N) bread
演講	yǎnjiǎng	(N) a speech, a public lecture
噢	òu	(Ptc) Oh
活動中心	huódòng zhōngxīn	activity center
想起來	xiǎng qǐlái	to have remembered
//當代中文/Book 2/L03-II		
選	xuǎn	(V) to select
作業	zuòyè	(N) homework, assignment
練習	liànxí	(V) to practice
半夜	bànyè	(N) middle of the night, late at night
高興	gāoxìng	(Vs) glad, pleased
平常	píngcháng	(Adv) usually
爬山	páshān	(V-sep) to go hiking
認識	rènshì	(Vpt) to get to know someone
聊天	liáotiān	(V-sep) to have a chat
文化	wénhuà	(N) culture
廣告	guǎnggào	(N) advertisement, commercial
位	wèi	(M) measure word for people (polite form)
了解	liǎojiě	(Vst) to understand
生活	shēnghuó	(N) life
陽明山	Yángmíng Shān	Yangming Mountain
外國人	wàiguó rén	foreigner
一些	yìxiē	a little bit of, some, a fair amount of
//當代中文/Book 2/L04-I		
高美玲	Gāo Měilíng	Gao Meiling, a woman from France
打工	dǎgōng	(V-sep) to work part-time
主任	zhǔrèn	(N) director
介紹	jièshào	(V) to introduce
歲	suì	(M) years of age
語言學	yǔyánxué	(N) linguistics
經驗	jīngyàn	(N) experience
談	tán	(V) to talk over, to talk about , to discuss
當	dāng	(V) to serve as
助教	zhùjiào	(N) teaching assistant
上午	shàngwǔ	(N) morning
除了	chúle	(Prep) except for, other than
年級	niánjí	(N) grade (year in school)
暑假	shǔjià	(N) summer vacation
請教	qǐngjiào	(V) to ask, to inquire (polite form)
貴	guì	(Vs-attr) your (honorable)
薪水	xīnshuǐ	(N) pay
算	suàn	(V) to calculate
按照	ànzhào	(Prep) based on, in accordance with
教授	jiàoshòu	(N) professor
鐘點費	zhōngdiǎn fèi	(N) hourly pay
份	fèn	(M) measure word for job
法文	Fǎwén	French language
亞洲	Yàzhōu	Asia
西班牙語	Xībānyá yǔ	Spanish language
英文	Yīngwén	English language
三年級	sān niánjí	grade three (school or university)
//當代中文/Book 2/L04-II		
法律	fǎlǜ	(N) law
夠	gòu	(Vs-pred) enough
履歷表	lǚlìbiǎo	(N) résumé
面談	miàntán	(Vi, N) to have an interview, interview
華僑	Huáqiáo	(N) overseas Chinese
辦公室	bàngōngshì	(N) office
談話	tánhuà	(V-sep) to talk
情形	qíngxíng	(N) situation
適合	shìhé	(Vst) suitable for
說明	shuōmíng	(V) to explain
然後	ránhòu	(Adv) afterwards, and then
月底	yuèdǐ	(N) the end of a month
發	fā	(V) to pay (wages)
馬上	mǎshàng	(Adv) immediately
答應	dāyìng	(V) to accept
順利	shùnlì	(Vs) to go, to proceed, smoothly
黃	Huáng	a common Chinese family name, literally “yellow”
沒想到	méi xiǎngdào	unexpectedly, didn't expect'
//當代中文/Book 2/L05-I		
喜酒	xǐjiǔ	(N) wedding banquet, wedding reception
恭喜	gōngxǐ	(V) to congratulate
新娘	xīnniáng	(N) bride
參加	cānjiā	(V) to attend
婚禮	hūnlǐ	(N) wedding ceremony
西裝	xīzhuāng	(N) a (western) suit
正式	zhèngshì	(Vs) formal
客人	kèrén	(N) guest
手	shǒu	(N) hand
照相機	zhàoxiàngjī	(N) camera
新郎	xīnláng	(N) bridegroom
站	zhàn	(Vi) to stand
白	bái	(Vs) white
帥	shuài	(Vs) handsome, good looking (of men)
禮服	lǐfú	(N) formal attire
座位	zuòwèi	(N) seat
看起來	kàn qǐlái	to look, it appears to me
//當代中文/Book 2/L05-II		
結婚	jiéhūn	(Vp-sep) to get married to
日子	rìzi	(N) day
親戚	qīnqī	(N) relatives
熱鬧	rènào	(Vs) to be boisterous, lively
慶祝	qìngzhù	(V) to celebrate
件	jiàn	(M) measure word for clothing
喜事	xǐshì	(N) an auspicious occasion, such as a wedding
請客	qǐngkè	(V-sep) to host a banquet, treat somebody to a meal
紅包	hóngbāo	(N) red envelope with cash gift
送	sòng	(V) to give a gift, to send off, to see off
新人	xīnrén	(N) newlyweds (used only at a wedding)
喜宴	xǐyàn	(N) wedding banquet, wedding reception
敬酒	jìngjiǔ	(V-sep) to make a toast (alcoholic drinks)
大人	dàrén	(N) adult
小孩	xiǎohái	(N) child, children
不得了	bùdéliǎo	(Vs) very; extremely; indicates severity
另外	lìngwài	(Det) another
糖	táng	(N) candies
離開	líkāi	(Vp) to depart, to leave
句	jù	(M) measure word for utterances
祝福	zhùfú	(V) to give blessings to
話	huà	(N) utterance, word
一會兒	yìhuǐr	in a moment
有說有笑	yǒushuō yǒuxiào	laughing and joking
有吃有喝	yǒuchī yǒuhē	an availability of food and drink
百年好合	bǎinián hǎohé	century-long matrimony, i.e., to have a long happy marriage
早生貴子	zǎoshēng guìzǐ	May you soon bear a child! (a traditional exhortation given to newly-weds)
//當代中文/Book 2/L06-I		
李東健	Lǐ Dōngjiàn	Li Dongjian, a man from Seoul
搬	bān	(V) to move to
河邊	hé biān	(N) riverside
公園	gōngyuán	(N) park
腳踏車	jiǎotàchē	(N) bicycle
正在	zhèngzài	(Adv) right in the middle of, currently engaged in
網站	wǎngzhàn	(N) website
資料	zīliào	(N) information
搬家	bān jiā	(V-sep) to move (home)
近	jìn	(Vs) near, close by
合約	héyuē	(N) contract, agreement
到期	dàoqí	(Vp) to expire
還好	háihǎo	(Adv) fortunately
光線	guāngxiàn	(N) natural lighting
重要	zhòngyào	(Vs) important
如果	rúguǒ	(Conj) if
別的	biéde	(Det) other
合適	héshì	(Vs) suitable
少	shǎo	(Vpt) to lack
可惜	kěxí	(Vs) to be a shame, a pity
放	fàng	(V) to store, to leave at a place
兩邊	liǎngbiān	(N) both places
願意	yuànyì	(Vaux) to be willing to
開	kāi	(V) to drive
存	cún	(V) to save
隨身碟	suíshēndié	(N) flash drive
什麼樣	shénmeyàng	what kind of
慢慢來	mànmàn lái	take your time
不急	bùjí	don't rush, no hurry'
//當代中文/Book 2/L06-II		
相當	xiāngdāng	(Adv) fairly
自行車	zìxíngchē	(N) bicycle
床	chuáng	(N) bed
桌子	zhuōzi	(N) desk, table
椅子	yǐzi	(N) chair
家具	jiājù	(N) furniture
而且	érqiě	(Conj) also
吵	chǎo	(Vs) noisy
生活費	shēnghuófèi	(N) living expenses
低	dī	(Vs) low
留	liú	(Vi, V) to stay / to leave behind
長	cháng	(Vs) long
討論	tǎolùn	(V) to have a discussion over, to go over with
社團	shètuán	(N) club, association
活動	huódòng	(N) activity
失望	shīwàng	(Vs) to be disappointed
放心	fàngxīn	(Vs-sep) not to worry, to rest assured
用	yòng	(V) to use
首爾	Shǒu'ěr'	Seoul
//當代中文/Book 2/L07-I		
垃圾	lèsè	(N) garbage
倒	dào	(V) to throw out (garbage)
丟	diū	(V) to throw, to throw away (garbage)
收	shōu	(V) to collect
以為	yǐwéi	(Vst) to assume wrongly
回收	huíshōu	(V) to recycle
規定	guīdìng	(N) rules, regulation
要不然	yàobùrán	(Conj) otherwise
皮包	píbāo	(N) purse
跑	pǎo	(Vi) to run
追	zhuī	(V) to run after, to chase
有趣	yǒuqù	(Vs) interesting
不壞	bú huài	(Vs) not too bad
天天	tiāntiān	everyday
汽水罐	qìshuǐ guàn	soda can
紙杯	zhǐbēi	paper cup
放下	fàngxià	put down
走出來	zǒu chūlái	to walk out of
怎麼辦	zěnmebàn	What now?
//當代中文/Book 2/L07-II		
聊	liáo	(V) to chat (about)
忽然	hūrán	(Adv) suddenly
聲音	shēngyīn	(N) sound
奇怪	qíguài	(Vs) strange, odd
袋子	dàizi	(N) bag
輛	liàng	(M) measure word for vehicles
一定	yídìng	(Vs-attr) fixed, set, at a certain…
地點	dìdiǎn	(N) location
為了	wèile	(Prep) to, for the sake of
保護	bǎohù	(V) to protect
分類	fēnlèi	(N) classification
利用	lìyòng	(V) to make use of
紙	zhǐ	(N) paper
瓶子	píngzi	(N) bottle
塑膠	sùjiāo	(N) plastic
資源	zīyuán	(N) resource
回收桶	huíshōutǒng	(N) recycling bin
城市	chéngshì	(N) city
聽見	tīngjiàn	to hear, to have heard
開過來	kāi guòlái	to drive over
走過去	zǒu guòqù	to walk over
丟進去	diū jìnqù	to throw into
路上	lùshàng	on the street
//當代中文/Book 2/L08-I		
功夫	gōngfū	(N) kungfu, martial arts
叫	jiào	(V) to call (for someone's attention)'
見	jiàn	(Ptc) accomplishment complete (in perception)
推	tuī	(V) to push
體育館	tǐyùguǎn	(N) gym
太極拳	tàijíquán	(N) Tai Chi, shadow boxing
師父	shīfù	(N) (kungfu or other skill) master
天分	tiānfèn	(N) gift, talent
懂	dǒng	(Vpt) to understand, to comprehend
起來	qǐlái	(Vp) to wake up
動作	dòngzuò	(N) movement
輕	qīng	(Vs) light, effortless, gentle
腿	tuǐ	(N) leg
了	liǎo	(Ptc) capability complement
下去	xiàqù	(Ptc) a temporal particle meaning to continue with an action
興趣	xìngqù	(N) interest
借	jiè	(V) to borrow
有天分	yǒu tiānfèn	to be gifted, talented
學會	xuéhuì	to learn, to master
起不來	qǐ bù lái	can't get up (from bed)'
走不了路	zǒu bù liǎo lù	can't walk'
//當代中文/Book 2/L08-II		
好處	hǎochù	(N) benefit
抱怨	bàoyuàn	(Vi) to complain
公尺	gōngchǐ	(N) meter
總是	zǒngshì	(Adv) always, invariably
完	wán	(Ptc) phase marker for ‘completion', to finish…'
體力	tǐlì	(N) physical strength
整天	zhěngtiān	(N) an entire day
精神	jīngshén	(N) spirit, energy
本來	běnlái	(Adv) originally
可能	kěnéng	(Vaux) maybe, probably
回	huí	(V) to return to
影響	yǐngxiǎng	(V) to influence, to interfere with
身體	shēntǐ	(N) body
練	liàn	(N) to practice, to train, to drill
想起	xiǎngqǐ	to recall
//當代中文/Book 2/L09-I		
春假	chūnjià	(N) spring break
好	hǎo	(Ptc) As a resultative particle, it indicates a proper completion of an action
到	dào	(Ptc) As a resultative particle, it indicates a successful completion of an action
特色	tèsè	(N) unique features, distinctive traits
夠	gòu	(Vs-pred) enough
顏色	yánsè	(N) color
廟	miào	(N) temple
像	xiàng	(Vst) similar to
教堂	jiàotáng	(N) church, cathedral
南部	nánbù	(N) southern region
潛水	qiánshuǐ	(V-sep) to dive (i.e., snorkel or scuba diving)
各	gè	(Det) various
魚	yú	(N) fish
酸	suān	(Vs) sour, tart
檸檬	níngméng	(N) lemon, lime
味道	wèidào	(N) taste, flavor
泰國	Tàiguó	Thailand
比起來	bǐ qǐlái	compared to
極了	jí le	absolutely, extremely
忘不了	wàng bù liǎo	unforgettable
//當代中文/Book 2/L09-II		
鄉下	xiāngxià	(N) countryside
氣氛	qìfēn	(N) atmosphere
鎮	zhèn	(N) rural town
不同	bùtóng	(Vs) different
現代	xiàndài	(N) modern
公寓	gōngyù	(N) apartment
馬路	mǎlù	(N) street
寬	kuān	(Vs) wide
汽車	qìchē	(N) car
建築	jiànzhú	(N) buildings
老	lǎo	(Vs) old
層	céng	(M) measure word for floors and storeys
北部	běibù	(N) the north
熱情	rèqíng	(Vs) hospitable, welcoming, warmhearted
擠	jǐ	(Vs) crowded
飲料	yǐnliào	(N) drink, beverage
巴黎	Bālí	Paris
高雄市	Gāoxióng Shì	Kaohsiung City in southern Taiwan
中南部	zhōngnánbù	central and southern regions
買得起	mǎi de qǐ	afford, affordable
百貨公司	bǎihuò gōngsī	department store
越來越	yuèláiyuè	more and more, increasingly
//當代中文/Book 2/L10-I		
馬丁	Mǎdīng	Martin, a man from the UK
包	bāo	(V) to wrap
餃子	jiǎozi	(N) dumplings
脫	tuō	(V) to remove, to take off (clothing)
鞋	xié	(N) shoes
關	guān	(V) to close
門	mén	(N) door
春捲	chūnjuǎn	(N) spring rolls
泡菜	pàocài	(N) kimchi, pickled vegetables
飯廳	fàntīng	(N) dining room
下	xià	(Ptc) to have enough space to accommodate
洗	xǐ	(V) to wash
做菜	zuòcài	(V-sep) to cook
水餃	shuǐjiǎo	(N) dumplings (when boiled in water)
煮	zhǔ	(V) to cook, to boil
壞	huài	(Vp) to go bad
破	pò	(Vp) to break, to split open
餡兒	xiànr	(N) filling
扁	biǎn	(Vs) flat
材料	cáiliào	(N) ingredients
道	dào	(M) measure word for dishes of food
飽	bǎo	(Vs) to have eaten enough, to be full
光	guāng	(Vp) to be finished, none left
鍋子	guōzi	(N) pot, kettle, pan, wok
筷子	kuàizi	(N) chopsticks
碗	wǎn	(N) bowl
韓國	Hánguó	(South) Korea
看不出來	kàn bù chūlái	It does not occur to me that…, can't tell (i.e., ascertain)'
酸辣湯	suānlà tāng	hot and sour soup
//當代中文/Book 2/L10-II		
學期	xuéqí	(N) semester (or school term)
趁	chèn	(Prep) while, take advantage of
皮	pí	(N) skin, wraps
嚐	cháng	(V) to savor, to taste
大白菜	dàbáicài	(N) Chinese cabbage
加	jiā	(V) to add
鹽	yán	(N) salt
拌	bàn	(V) to stir, to mix
辣椒	làjiāo	(N) chili peppers
調味料	tiáowèiliào	(N) seasonings
裝	zhuāng	(V) to pack into
玻璃	bōlí	(N) glass
壽司	shòusī	(N) sushi
像	xiàng	(Vst) such as; like
食物	shíwù	(N) food
做起來	zuò qǐlái	when undertaken, to do
//當代中文/Book 2/L11-I		
其他	qítā	(Det) other, the other, the remaining
假期	jiàqí	(N) vacation, holiday
溫泉	wēnquán	(N) hot springs
建議	jiànyì	(V) to suggest, to recommend
票	piào	(N) ticket
考慮	kǎolǜ	(V) to consider
順便	shùnbiàn	(Adv) without making any extra effort, on the way, while doing something else, while one is at it
湖	hú	(N) lake
原住民	yuánzhùmín	(N) aborigines
趟	tàng	(M) measure word for a trip
後來	hòulái	(Adv) later
注意	zhùyì	(V) to pay attention to
沙灘	shātān	(N) beach
錢包	qiánbāo	(N) wallet, purse
不見	bújiàn	(Vp) to be lost, to disappear
被	bèi	(Ptc) a particle marking a passive sentence
偷	tōu	(V) to steal
安全	ānquán	(Vs) safe
值得	zhíde	(Vs) worthwhile, worth
墾丁	Kěndīng	Kenting, an area on the southern tip of Taiwan, famed for beaches and rain forest
台中	Táizhōng	Taichung city, in central Taiwan
日月潭	Rìyuè Tán	Sun Moon Lake, in central Taiwan
水上活動	shuǐshàng huódòng	water activities, water recreation
風景區	fēngjǐngqū	scenic area
//當代中文/Book 2/L11-II		
又	yòu	(Adv) then
遍	biàn	(M) measure word for number of times
民宿	mínsù	(N) Bed & Breakfast lodgings
運氣	yùnqì	(N) luck
摩托車	mótuōchē	(N) motorcycle
熱帶	rèdài	(N) tropical region
植物	zhíwù	(N) plants
所有	suǒyǒu	(Vs-attr) all
白天	báitiān	(N) in the daytime
躺	tǎng	(Vi) to lie down
黃昏	huánghūn	(N) dusk
條	tiáo	(M) measure word for street
街	jiē	(N) street
啤酒	píjiǔ	(N) beer
上	shàng	(Ptc) a verb particle indicating the coming into contact between two nouns
又	yòu	(Conj) and
浪漫	làngmàn	(Vs) romantic
家鄉	jiāxiāng	(N) hometown, usually a village
觀光客	guānguāngkè	tourist
曬太陽	shài tàiyáng	to sunbathe
水上摩托車	shuǐshàng mótuōchē	jet skis
愛上	àishàng	to fall in love with
//當代中文/Book 2/L12-I		
新	xīn	(Adv) newly
開	kāi	(V) to open (business)
素食	sùshí	(N) vegetarian food
速食	sùshí	(N) fast food
錯	cuò	(Vp) to be mistaken, wrong
肉	ròu	(N) meat
欸	èi	(Ptc) an interjection particle, calling for attention
讓	ràng	(V) to let, to make
吃素	chīsù	(V-sep) to be a vegetarian, to eat vegetarian food
漢堡	hànbǎo	(N) hamburger
變	biàn	(Vp) to become
胖	pàng	(Vs) fat
素菜	sùcài	(N) vegetarian food, dishes
油膩	yóunì	(Vs) oily, greasy
樣	yàng	(M) measure word for dishes, kinds
好奇	hàoqí	(Vs) curious, to wonder
女孩	nǚhái	(N) girl
青菜	qīngcài	(N) vegetables
瘦	shòu	(Vs) thin
室友	shìyǒu	(N) roommate
豬肉	zhūròu	(N) pork
西方	xīfāng	(N) the West, western
完全	wánquán	(Adv) completely
鹹	xián	(Vs) salty
炸	zhá	(V) to deep fry
烤	kǎo	(V) to grill, to roast, to BBQ
沙拉	shālā	(N) salad
麥當勞	Màidāngláo	McDonald's'
速食店	sùshí diàn	fast food restaurant
//當代中文/Book 2/L12-II		
只要	zhǐyào	(Conj) as long as
討厭	tǎoyàn	(Vst) to dislike
餐	cān	(M) measure word for meal
宗教	zōngjiào	(N) religion
關係	guānxi	(N) relationship
薯條	shǔtiáo	(N) French fries
作法	zuòfǎ	(N) way of doing something, e.g., cooking
越	yuè	(Adv) more
簡單	jiǎndān	(Vs) simple
蒸	zhēng	(V) to steam
有機	yǒujī	(Vs-attr) organic
食品	shípǐn	(N) food
地球	dìqiú	(N) the earth
汙染	wūrǎn	(N) pollution
嚴重	yánzhòng	(Vs) serious
衛生	wèishēng	(N) hygiene
營養	yíngyǎng	(N) nutrition
什麼的	shénmede	things like (that); etc
//當代中文/Book 2/L13-I		
林愛麗	Lín Àilì	Lin Aili, a woman from Canada
掉	diào	(Vp) to lose
低頭	dītóu	(V-sep) to lower one's head'
傳	chuán	(V) to send (text message, email)
過	guò	(Ptc) a phase particle indicating completion of an action
簡訊	jiǎnxùn	(N) text message
功能	gōngnéng	(N) function
生氣	shēngqì	(Vs-sep) to get angry at
叫	jiào	(V) to tell
罵	mà	(V) to yell at, to scold, to tell off
健身房	jiànshēnfáng	(N) gym
啦	la	(Ptc) a sentence-final particle indicating a question, 了+啊
查	chá	(V) to check, to look up (for information)
班機	bānjī	(N) flight
訂位	dìngwèi	(V-sep) to make reservations
電	diàn	(N) electric power
充電	chōngdiàn	(V-sep) to charge (the battery of an electronic device)
糊塗	hútú	(Vs) muddle-headed
喔	ō	(Ptc) a sentence-final particle indicating a suggestion
義大利	Yìdàlì	Italy
拿走	názǒu	to take away
撿到	jiǎndào	to find something, to pick up
留下	liúxià	to keep for oneself
//當代中文/Book 2/L13-II		
網路	wǎnglù	(N) the internet
發生	fāshēng	(Vp) to happen
事情	shìqíng	(N) event, happening
消息	xiāoxí	(N) news, information
透過	tòuguò	(Prep) through
世界	shìjiè	(N) the world
節省	jiéshěng	(V) to save
起床	qǐchuáng	(Vp-sep) to get out of bed
檢查	jiǎnchá	(V) to check
郵件	yóujiàn	(N) mail
立刻	lìkè	(Adv) immediately
上傳	shàngchuán	(V) to upload, to post
正常	zhèngcháng	(Vs) to be normal
談	tán	(V) to talk over, to talk about, to discuss
現代人	xiàndài rén	modern day people, people today
比方說	bǐfāng shuō	for example
做到	zuòdào	to be able to achieve, to succeed in doing
第一手	dìyīshǒu	first hand
急著	jízhe	in a hurry to
打招呼	dǎ zhāohū	to greet someone; to say hello; to wave at someone
面對面	miàn duì miàn	face-to-face
//當代中文/Book 2/L14-I		
將來	jiānglái	(N) the future
徵求	zhēngqiú	(V) to seek, to invite applications for
教師	jiàoshī	(N) instructor
認為	rènwéi	(Vst) to have the opinion that, to think
畢業	bìyè	(Vp-sep) to graduate
發展	fāzhǎn	(V) to develop
連	lián	(Prep) even
想法	xiǎngfǎ	(N) thoughts, way of thinking, idea
不但	búdàn	(Conj) not only
繼續	jìxù	(Vaux) to continue
使用	shǐyòng	(V) to make use of, to use
實現	shíxiàn	(Vp) to come true, to realize
招待	zhāodài	(V) to entertain, to play host to
研究所	yánjiùsuǒ	(N) graduate school
聚	jù	(Vi) to get together
香港	Xiānggǎng	Hong Kong
上海	Shànghǎi	Shanghai
說到	shuōdào	to mention
念完	niànwán	to complete (an academic program)
分公司	fēngōngsī	branch office
捨不得	shěbùde	reluctant to part with
聚一聚	jù yí jù	get together
//當代中文/Book 2/L14-II		
當時	dāngshí	(Adv) at that time
聲調	shēngdiào	(N) tones
發音	fāyīn	(N) pronunciation
準	zhǔn	(Vs) to be accurate
企業	qìyè	(N) enterprise
管理	guǎnlǐ	(N) management
系	xì	(N) academic department (of a university)
經濟	jīngjì	(N) economy
幫助	bāngzhù	(N) help
有關	yǒuguān	(Vst) to be related to
語法	yǔfǎ	(N) syntax, grammar
研究	yánjiù	(V) to do research in
教書	jiāoshū	(V-sep) to teach
方法	fāngfǎ	(N) method, approach
目的	mùdì	(N) goal, objective
國際	guójì	(Vs-attr) international
翻譯	fānyì	(N) translator, interpreter
外交	wàijiāo	(N) diplomacy, foreign affairs
人員	rényuán	(N) staff, personnel
充實	chōngshí	(V) to enrich, to strengthen
專業	zhuānyè	(N) profession, specialisation
能力	nénglì	(N) capacity, ability
加拿大	Jiānádà	Canada
企業管理系 （企管系）	qìyè guǎnlǐ xì	department of business management
國際關係	guójì guānxì	international relations
//當代中文/Book 2/L15-I		
春節	chūnjié	(N) the Lunar New Year, the Spring Festival
伯伯	bóbo	(N) (older) uncle, friends' fathers in general'
年夜飯	niányèfàn	(N) Lunar New Year's Eve dinner'
打擾	dǎrǎo	(V) to trouble (someone), to disturb
女兒	nǚ'ér'	(N) daughter
國外	guówài	(N) abroad
圍爐	wéilú	(V-sep) for a family to gather over Lunar New Year's Eve dinner'
意思	yìsi	(N) meaning
全家	quánjiā	(N) the entire family
孩子	háizi	(N) children
吉祥	jíxiáng	(Vs) auspicious
年紀	niánjì	(N) age
過年	guò nián	to celebrate the Lunar New Year
除夕夜	chúxì yè	Luner New Year's Eve'
睡著	shuìzháo	to fall asleep
壓歲錢	yāsuìqián	New Year's Eve money'
恭喜發財	gōngxǐ fācái	Congratulations. I wish you wealth
好了	hǎo le	OK
//當代中文/Book 2/L15-II		
節日	jiérì	(N) holiday, festival
打掃	dǎsǎo	(V) to clean up (must include sweeping)
另外	lìngwài	(Conj) in addition
春聯	chūnlián	(N) New Year's couplets (with calligraphy, in doublets)'
除夕	chúxì	(N) Lunar New Year's Eve'
年糕	niángāo	(N) new year rice cake
橘子	júzi	(N) orange, tangerine
守歲	shǒusuì	(Vi) to stay up waiting for the arrival of the New Year
說法	shuōfǎ	(N) way of saying things, a theory
晚	wǎn	(Vs) late
活	huó	(Vs) to live, to stay active
平安	píng'ān'	(Vs) peaceful, eventless
出門	chūmén	(V-sep) to go out, to leave the house
拜年	bàinián	(V-sep) to pay a New Year visit
又	yòu	(Adv) again
起來	qǐlái	(Ptc) As a resultative particle, it indicates the beginning of an action or state
華人	Huárén	Chinese, a person of Chinese ethnicity
貼上	tiēshàng	to stick on (the wall)
年年有餘	niánnián yǒuyú	abundance every year
步步高升	bùbù gāoshēng	to rise in social rank
大吉大利	dàjí dàlì	great wishes for the new year
放鞭炮	fàng biānpào	to set off firecrackers
大年初一	dànián chūyī	first day of the Lunar New Year
大年初五	dànián chūwǔ	fifth day of the Lunar New Year
//當代中文/Book 3/L01-I		
安德思	Ān Désī	a man from Honduras
羅珊蒂	Luó Shāndì	a woman from Indonesia
何雅婷	Hé Yǎtíng	a woman from Taiwan
開學	kāixué	(Vp) (school) to start
班	bān	(N) class, i.e., the students (not the classroom or the course)
新生	xīnshēng	(N) new student
嚴	yán	(Vs) strict, stern
口試	kǒushì	(N) oral test
筆試	bǐshì	(N) written test
以外	yǐwài	(N) except, other than
口頭	kǒutóu	(Vs-attr) verbal, oral
報告	bàogào	(N) report
壓力	yālì	(N) pressure, stress
說明	shuōmíng	(N) instructions, explanation
清楚	qīngchǔ	(Vs) clear(ly)
位子	wèizi	(N) seat, place
旁聽	pángtīng	(V) to audit,to sit in (on a class)
分	fēn	(N) points
羨慕	xiànmù	(Vst) to envy
休學	xiūxué	(Vp-sep) to take a break from school
用功	yònggōng	(Vs) diligent, conscientious (as a student)
行	xíng	(Vs) to be all right
轉	zhuǎn	(V) to transfer (to a different major)
原來	yuánlái	(Adv) originally
會計	kuàijì	(N) accounting, an accountant
熱門	rèmén	(Vs) highly popular
熬夜	áoyè	(V-sep) to stay up all night, to burn the midnight oil
當	dàng	(V) to fail a course
恐怕	kǒngpà	(Adv) (I am) afraid that, probably
口才	kǒucái	(N) speaking skills
事	shì	(N) issue, matter, event, thing
遲到	chídào	(Vp) to be late (in arrival)
差一點	chà yì diǎn	barely, nearly, almost
這樣下去	zhèyàng xiàqù	if it goes on like this
沒辦法	méi bànfǎ	there's no way, there's nothing that can be done'
//當代中文/Book 3/L01-II		
獨生女	dúshēngnǚ	(N) only child (girl)
私立	sīlì	(Vs-attr) private
理想	lǐxiǎng	(Vs) ideal, aspired
合	hé	(Vst) to tally with, to match
痛苦	tòngkǔ	(Vs) painful
科系	kēxì	(N) (academic) department
放棄	fàngqì	(V) to give up
不管	bùguǎn	(Conj) no matter, regardless of
反對	fǎnduì	(Vst) to oppose, to be against
個性	gèxìng	(N) personality
活潑	huópō	(Vs) lively, bubbly, vivacious
外語	wàiyǔ	(N) foreign language
擔心	dānxīn	(Vst) to worry about, to fret over with
填	tián	(V) to fill out (a form)
表	biǎo	(N) a form
辦	bàn	(V) to deal with
手續	shǒuxù	(N) procedures
申請	shēnqǐng	(V) to apply for
成績單	chéngjī dān	(N) report card, transcripts
考上	kǎoshàng	to test into
推薦信	tuījiàn xìn	a letter of recommendation
//當代中文/Book 3/L02-I		
起	qǐ	(Vp) starting from
外套	wàitào	(N) coat, jacket
一般	yìbān	(Adv) generally; in general
商品	shāngpǐn	(N) goods, commodities
折扣	zhékòu	(N) discount
省	shěng	(V) to save, to put away
牌子	páizi	(N) brand
品質	pǐnzhí	(N) quality
選擇	xuǎnzé	(N) choices
樣子	yàngzi	(N) appearance, looks
摸	mō	(V) to feel, to touch
店員	diànyuán	(N) salesperson, store employee, clerk
短	duǎn	(Vs) short
羊毛	yángmáo	(N) lamb's wool'
暖和	nuǎnhuo	(Vs) warm
打折	dǎzhé	(V-sep) to offer a discount
原價	yuánjià	(N) original price
刷卡	shuākǎ	(V-sep) to swipe, i.e., use a credit card
現金	xiànjīn	(N) cash
麻煩	máfán	(V) please (lit. allow me to trouble you)
簽名	qiānmíng	(V-sep) to sign
破洞	pòdòng	(Vp-sep) to have a hole
發票	fāpiào	(N) receipt
弄	nòng	(V) (pro-verb) to cause, to do
退	tuì	(V) to return (purchases)
換	huàn	(V) to exchange
店長	diànzhǎng	(N) store manager
週年慶	zhōunián qìng	anniversary
一般來說	yìbān láishuō	generally speaking
試穿	shì chuān	to try on (garments)
打完折	dǎ wán zhé	after discount
弄丟	nòng diū	to lose
//當代中文/Book 3/L02-II		
購物	gòuwù	(Vi) to go shopping
糾紛	jiūfēn	(N) dispute
電信	diànxìn	(N) telecommunications
門市	ménshì	(N) retail outlet
居留證	jūliúzhèng	(N) Alien Resident Certificate (ARC in Taiwan)
月租型	yuèzūxíng	(N) a monthly plan
帳單	zhàngdān	(N) bill
並	bìng	(Adv) contrary to assumption (followed by a negative statement)
包括	bāokuò	(V) to include
解釋	jiěshì	(N) explanation
顧客	gùkè	(N) customer
尤其	yóuqí	(Adv) especially, in particular
騙	piàn	(V) to cheat, to swindle
頓	dùn	(M) verbal measure word for a duration of action
辦法	bànfǎ	(N) solution
自動	zìdòng	(Adv) by itself, on its own, automatically
關機	guānjī	(Vp-sep) to turn off, to shut down
修理	xiūlǐ	(V) to repair
繳費	jiǎofèi	(V-sep) to pay a fee
預付卡	yùfù kǎ	prepaid SIM card
換成	huàn chéng	to change to
吃到飽	chī dào bǎo	unlimited data (lit. all you can eat)
嚇一跳	xià yí tiào	shocked, startled, taken aback
客服中心	kèfú zhōngxīn	customer service center
//當代中文/Book 3/L03-I		
陳敏萱	Chén Mǐnxuān	A woman from the Netherlands
高橋健太	Gāoqiáo Jiàntài	A man from Japan
空氣	kōngqì	(N) air
影響	yǐngxiǎng	(N) influence
穩定	wěndìng	(Vs) stable
幸虧	xìngkuī	(Adv) fortunately
躲	duǒ	(Vi) to hide, to go into hiding
度	dù	(M) degree
溫度	wēndù	(N) temperature
零下	língxià	(Vs-attr) below zero
感覺	gǎnjué	(Vst) to feel
實際	shíjì	(Vs) actual
難怪	nánguài	(Adv) it's no wonder, no wonder'
季節	jìjié	(N) season
火鍋	huǒguō	(N) hotpot
海鮮	hǎixiān	(N) seafood
新鮮	xīnxiān	(Vs) fresh
櫻花	yīnghuā	(N) cherry blossom
變化	biànhuà	(N) change
氣溫	qìwēn	(N) temperature (weather)
差	chā	(Vst) to differ
幾乎	jīhū	(Adv) almost
乾	gān	(Vs) dry
發霉	fāméi	(Vp-sep) to mildew
除濕機	chúshījī	(N) dehumidifier
雨季	yǔjì	(N) rainy season
涼快	liángkuài	(Vs) cool
潮濕	cháoshī	(Vs) humid
悶	mēn	(Vs) stuffy
冷氣	lěngqì	(N) air conditioning
荷蘭	Hélán	the Netherlands (lit. Holland)
出大太陽	chū dà tàiyáng	to be blazing hot
颳風	guā fēng	to be windy (lit. blow wind)
受到	shòu dào	to receive, to be, to get
受不了	shòu bù liǎo	can't stand it'
餓死了	è sǐle	to starve to death (an exaggeration)
後母臉	hòumǔ liǎn	stepmother's face, i.e., stern and cruel look'
//當代中文/Book 3/L03-II		
祖先	zǔxiān	(N) ancestor
移民	yímín	(Vi) to immigrate, to emigrate
當中	dāngzhōng	(N) of, amongst
根據	gēnjù	(Prep) based on, in accordance with, according to
農曆	nónglì	(N) the lunar calendar (lit. the agricultural calendar)
農業	nóngyè	(N) agriculture
農人	nóngrén	(N) farmer
難得	nándé	(Vs) hard-to-come-by, rare
祭祖	jìzǔ	(Vi) to venerate ancestors
拜	bài	(V) to honor, to pay homage to
神	shén	(N) gods, divinities
拜拜	bàibài	(Vi) to present offerings to gods or ancestors
蚊蟲	wénchóng	(N) mosquitoes and other insects
戴	dài	(V) to wear (items other than those that cover the torso, legs, or feet, mostly ornamental items.)
香包	xiāngbāo	(N) fragrant sachet
掛	guà	(V) to hang
瘟疫	wēnyì	(N) pestilence, plague
做法	zuòfǎ	(N) method, way of doing something
多少	duōshǎo	(Adv) somewhat
作用	zuòyòng	(N) effect
迷信	míxìn	(N) superstition
收成	shōuchéng	(N) harvest
民族	mínzú	(N) ethnic group
月亮	yuèliàng	(N) moon
圓	yuán	(Vs) round
社會	shèhuì	N society
團聚	tuánjù	(Vi) to get-together, to reunite; reunion of family members (in this lesson)
月餅	yuèbǐng	(N) moon cake (shaped like the moon)
柚子	yòuzi	(N) pomelo
故事	gùshì	(N) story
溫馨	wēnxīn	(Vs) warm, heart-warming
端午節	Duānwǔ jié	the Dragon Boat Festival (the 5th day of the 5th month)
中秋節	Zhōngqiū jié	the Mid-autumn Moon Festival (the 15th day of the 8th month)
雄黃酒	xiónghuáng jiǔ	realgar liquor, a wine seasoned with realgar, a type of arsenic, and is traditionally considered to be an antidote to other poisons
古時候	gǔ shíhòu	historically; in ancient times
趕走	gǎnzǒu	to drive away
過節	guò jié	to spend the holiday in some manner
//當代中文/Book 3/L04-I		
愛	ài	(Vst) to love
人情味	rénqíngwèi	(N) to be hospitable, kind, friendly
放	fàng	(V) to release
天燈	tiāndēng	(N) sky lantern
願望	yuànwàng	(N) wish
訊號	xùnhào	(N) signal (data connection)
元宵	yuánxiāo	(N) sweet sticky rice dumplings
牆	qiáng	(N) wall
耐心	nàixīn	(N) patience
感動	gǎndòng	(Vs) to be touched, moved
擔仔麵	dànzǎimiàn	(N) danzai noodles (special dish from Tainan)
招牌	zhāopái	(N) store sign
當地	dāngdì	(Vs-attr) local
賺	zhuàn	(V) to earn
而	ér	(Adv) on the other hand, rather
交	jiāo	(V) to make (friends)
理想	lǐxiǎng	(N) ideals, aspirations
剛剛	gānggāng	(Adv) just now
改天	gǎitiān	(Adv) some other day
無聊	wúliáo	(Vs) boring, dull
東區	dōngqū	(N) the East District (of Taipei)
煙火	yānhuǒ	(N) fireworks
跨年	kuànián	(Vi) welcome in the (solar) New Year (lit. span years)
種類	zhǒnglèi	(N) type, category
價錢	jiàqián	(N) price
感覺	gǎnjué	(N) feeling; a feeling of
雞排	jīpái	(N) chicken fillet
口	kǒu	(M) mouthful
紅茶	hóngchá	(N) black tea (lit. red tea)
平溪	Píngxī	Pingxi, a town in northern Taiwan
元宵節	Yuánxiāo jié	the Lantern Festival (15th day of the 1st month)
孔廟	Kǒngmiào	Confucian Temple
校外教學	xiàowài jiāoxué	field trip, class excursion
碰到	pèngdào	to run into
水煎包	shuǐjiān bāo	pan-fried pork bun
//當代中文/Book 3/L04-II		
同事	tóngshì	(N) colleague, coworker
美食	měishí	(N) delicacies, delicious foods
上	shàng	(V) to go up to
泡	pào	(V) to steep (tea) / to soak oneself in, i.e., to bath in
錯過	cuòguò	(Vpt) to miss (an opportunity)
營業	yíngyè	(Vi) to open for business, in operation (businesses)
夜景	yèjǐng	(N) night view
古老	gǔlǎo	(Vs) ancient, antiquated
古蹟	gǔjī	(N) historical site
重視	zhòngshì	(Vst) to place emphasis on, to lay stress on, to value
歷史	lìshǐ	(N) history
風俗	fēngsú	(N) customs
習慣	xíguàn	(N) habit
道地	dàodì	(Vs) authentic
粥	zhōu	(N) congee, watery rice
講究	jiǎngjiù	(Vst) to be discriminating in, to be discerning, meticulous
頓	dùn	(M) measure word for the duration of a meal
速度	sùdù	(N) speed
窄	zhǎi	(Vs) narrow
街道	jiēdào	(N) street
蓋	gài	(V) to build, to erect
待	dāi	(Vi) to stay, to remain
欣賞	xīnshǎng	(V) to appreciate, to enjoy
美麗	měilì	(Vs) beautiful
鈴木	Língmù	Japanese last name: Lingmu (Japanese: Suzuki)
赤崁樓	Chìkǎn lóu	Chihkan Tower, a.k.a. Fort Provintia (stronghold built by the Dutch, in Tainan, in the 17th  century)
留下來	liú xià lái	to leave behind
木造	mùzào	wooden; made from wood
非去不可	fēiqù bùkě	Visiting (it) is a must!!
//當代中文/Book 3/L05-I		
流行	liúxíng	(Vst) popular
唉	āi	(Ptc) Oh no! Oh boy!
演唱會	yǎnchànghuì	(N) concert
塞車	sāichē	(Vs) net congestion, jam
上線	shàngxiàn	(V-sep) to log in, go online
成功	chénggōng	(Vp) to succeed
倒楣	dǎoméi	(Vs) out of luck, down on one's luck'
樂團	yuètuán	(N) (music) band
唱	chàng	(V) to sing
興奮	xīngfèn	(Vs) excited
迷	mí	(Vst) to be enamored with, be into, be enchanted by, be obsessed with
歌詞	gēcí	(N) lyrics
難過	nánguò	(Vs) sad
不如	bùrú	(Vst) inferior to
現場	xiànchǎng	(N) live; lit. on-site
跳	tiào	(Vi) to jump
整	zhěng	(Det) entire, whole
震動	zhèndòng	(Vi) to vibrate, to shake
漫畫	mànhuà	(N) comics
內容	nèiróng	(N) content
色情	sèqíng	(Vs) pornographic; obscene
放鬆	fàngsōng	(Vst) to relax
心情	xīnqíng	(N) mood
五月天	Wǔyuètiān	Mayday (name of a Taiwanese rock band)
算了	suàn le	forget it; let it be!
受歡迎	shòu huānyíng	well-received; well-liked; popular
擠滿	jǐmǎn	crowded with, packed with
租書店	zūshū diàn	book rental store
平板電腦	píngbǎn diànnǎo	tablet computer
智慧型手機	zhìhuìxíng shǒujī	smartphone
殺時間	shā shíjiān	to kill time
漫畫展	mànhuà zhǎn	comic (book) exhibition
來不及	lái bù jí	not be in time for, not make it on time
//當代中文/Book 3/L05-II		
撞衫	zhuàngshān	(Vs) "wardrobe clash", more than one person unintentionally wearing duplicate garments
它	tā	(N) it
塞	sāi	(V) to stuff, cram, squeeze (into)
當季	dāngjì	(N) in season
款式	kuǎnshì	(N) style (of clothes)
連續劇	liánxùjù	(N) TV series
主角	zhǔjiǎo	(N) leading role, leading actor
甜美	tiánměi	(Vs) sweet and cute, lovely
寄	jì	(V) to mail
居然	jūrán	(Adv) unexpectedly, counter to assumption
害	hài	(V) adversely impacting somebody so that they…
既然	jìrán	(Conj) since, given that…
服裝	fúzhuāng	(N) clothing, garments
媒體	méitǐ	(N) the media
方式	fāngshì	(N) method, ways
吸引	xīyǐn	(Vst) to attract, to draw
避免	bìmiǎn	(V) to avoid
包包	bāobāo	(N) bag, purse
商人	shāngrén	(N) businessperson
產品	chǎnpǐn	(N) product
電子	diànzǐ	(N) electronics
市場	shìchǎng	(N) market
新型	xīnxíng	(Vs-attr) new style
落伍	luòwǔ	(Vs) behind the times, passé, old-fashioned
知音	zhīyīn	(N) bosom buddy, confidant
想像	xiǎngxiàng	(V) to imagine
喇叭褲	lǎbākù	(N) bell-bottom pants
印象	yìnxiàng	(N) impression
遊戲	yóuxì	(N) game
化妝	huàzhuāng	(V-sep) to apply cosmetics, to make up
一模一樣	yìmó yíyàng	identical
淺藍色	qiǎn lánsè	light blue
脫掉	tuōdiào	to take off (clothing)
小題大作	xiǎotí dàzuò	to make a mountain out of a molehill, to make a big deal of nothing
推出	tuīchū	to introduce, to roll out (products)
//當代中文/Book 3/L06-I		
李文彥	Lǐ Wényàn	an American-born Chinese
表哥	biǎogē	(N) cousin (older male cousin, from a female lineage)
隨便	suíbiàn	(Adv) as one pleases oneself, to act freely
種	zhòng	(V) to grow (plants)
蔬菜	shūcài	(N) vegetable
農夫	nóngfū	(N) farmer
減少	jiǎnshǎo	(V) to reduce, to decrease
農藥	nóngyào	(N) pesticide
天然	tiānrán	(Vs-attr) natural
堆肥	duīféi	(N) compost
辛苦	xīnkǔ	(Vs) tough, hard, bitter (life, work, etc.)
地位	dìwèi	(N) position, status
收入	shōurù	(N) income
利潤	lìrùn	(N) profit
屋子	wūzi	(N) house
番茄	fānqié	(N) tomato
品種	pǐnzhǒng	(N) variety, species
氣候	qìhòu	(N) climate
長	zhǎng	(Vi) to grow
熟	shóu	(Vp) to be ripe, to ripen
片	piàn	(M) measure word for a stretch, swath (of land)
田	tián	(N) field, plot of land, paddy
照顧	zhàogù	(V) to take care of
敢	gǎn	(Vaux) to dare
條件	tiáojiàn	(N) terms, conditions, (here) good qualities (in a prospective spouse)
黑	hēi	(Vp) dark, black
摘下來	zhāi xiàlái	to pluck, to pick (e.g., fruit from a tree)
做不動	zuò bú dòng	to be unable to physically function due to old age
基因改造	jīyīn gǎizào	genetically modified
忙得過來	máng de guòlái	to be able to manage everything
開玩笑	kāi wánxiào	to joke, to kid
看天吃飯	kàntiān chīfàn	livelihood depends on the whims of nature
//當代中文/Book 3/L06-II		
小農	xiǎonóng	(N) small farmer
市集	shìjí	(N) bazaar, market
食材	shícái	(N) food materials, ingredients
產地	chǎndì	(N) place of origin
盡量	jìnliàng	(Adv) to do one's best to'
友善	yǒushàn	(Vs) friendly
對待	duìdài	(V) to treat
土地	tǔdì	(N) land
信任	xìnrèn	(Vst) to trust
寧可	níngkě	(Vst) would rather
跑	pǎo	(Vi) to run
支持	zhīchí	(V) to support
文章	wénzhāng	(N) article
推銷	tuīxiāo	(V) to promote, to market
其中	qízhōng	(N) of these, of which, amongst which
師傅	shīfù	(N) master (of a trade)
農村	nóngcūn	(N) farming village
長大	zhǎngdà	(Vi) to grow up
幫助	bāngzhù	(V) to help
拜訪	bàifǎng	(V) to pay someone a visit
出產	chūchǎn	(V) to produce
由於	yóuyú	(Conj) due to, because of
許多	xǔduō	(Det) many
接近	jiējìn	(Vst) to come close to, to approach
自然	zìrán	(N) nature
變成	biànchéng	(Vpt) to become
休閒	xiūxián	(Vs) leisure
隨著	suízhe	(Prep) along with, with the happening of
觀光	guānguāng	(Vi) to tour, to sightsee
消費	xiāofèi	(Vi) to be a consumer, to purchase things
安靜	ānjìng	(Vs) quiet
消失	xiāoshī	(Vp) to disappear
出問題	chū wèntí	to go wrong, to have problems
一方面	yì fāngmiàn	on the one hand
//當代中文/Book 3/L07-I		
親	qīn	(Vs) close (as of familial relationship)
爺爺	yéye	(N) grandpa (father's side)'
鄰居	línjū	(N) neighbor
狗	gǒu	(N) dog
叫	jiào	(Vi) to bark
嗯	en	(Ptc) an interjection indicating the speaker's agreement'
奶奶	nǎinai	(N) grandma (father's side)'
過世	guòshì	(Vp) to die, pass away (honorific)
領養	lǐngyǎng	(V) to adopt
隻	zhī	(M) measure word for animals
可愛	kě'ài'	(Vs) cute
孤單	gūdān	(Vs) lonely
牠	tā	(N) it (animals)
髒	zāng	(Vs) dirty
洗澡	xǐzǎo	(V-sep) to take a bath
養	yǎng	(V) to raise, to keep
亂	luàn	(Adv) arbitrarily, without rhyme or reason
咬	yǎo	(V) to bite
打	dǎ	(V) to hit, beat, smack, slap
分手	fēnshǒu	(Vp) to break up (said of romantic relationships)
緊張	jǐnzhāng	(Vs) tense
減輕	jiǎnqīng	(V) to reduce
送	sòng	(V) to take to
美容院	měiróngyuàn	(N) beauty salon
推車	tuīchē	(N) stroller
主人	zhǔrén	(N) master, owner
相處	xiāngchǔ	(Vi) to get along (with), to spend time together
生	shēng	(V) to give birth, to bear
寵物	chǒngwù	(N) pet
單身	dānshēn	(Vs) to be single
醫院	yīyuàn	(N) hospital
意見	yìjiàn	(N) suggestion, opinion
建立	jiànlì	(V) to establish
散步	sànbù	(V-sep) to take a walk
家庭	jiātíng	(N) family
真正	zhēnzhèng	(Vs-attr) real, true, genuine
幸福	xìngfú	(N) happiness, blessing
跌倒	dié dǎo	to fall down
當成	dāngchéng	to consider, view as, regard
忍不住	rěnbúzhù	to be beyond the limits of endurance
//當代中文/Book 3/L07-II		
多元	duōyuán	(Vs-attr) diverse, diversified
阿姨	āyí	(N) aunt (mother's sisters)'
先生	xiānshēng	(N) husband
下班	xiàbān	(V-sep) to get off work
改	gǎi	(V) correct, check (homework)
公公	gōnggōng	(N) father-in-law (of a female)
全	quán	(Adv) completely, entirely
靠	kào	(V) to depend on, rely on
單親	dānqīn	(Vs-attr) single parent
貴族	guìzú	(N) nobility, aristocrat
時代	shídài	(N) period, time of
強	qiáng	(Vs) strong
追	zhuī	(V) to go after someone trying to establish a relationship of love, to chase
自由	zìyóu	(Vs) free
獨立	dúlì	(Vs) independent
安排	ānpái	(V) to handle, to arrange
享受	xiǎngshòu	(Vst) to enjoy
身邊	shēnbiān	(N) by one's side'
伴	bàn	(N) companion
同居	tóngjū	(Vi) to live together (as a couple), to cohabit
成家	chéngjiā	(Vp) to set up a family, to marry (from the male's perspective)'
負擔	fùdān	(V) to bear (a burden, responsibility)
養家	yǎngjiā	(V-sep) to support one's family'
責任	zérèn	(N) responsibility
亂	luàn	(Vs) to be in turmoil, be in chaos
教養	jiàoyǎng	(V) to raise, bring up, train, educate (one's children)'
接受	jiēshòu	(V) to accept
組成	zǔchéng	(V) to form
道德	dàodé	(Vs) moral
因此	yīncǐ	(Conj) therefore, so
完整	wánzhěng	(Vs) complete, integral, whole
美真	Měizhēn	female person's name'
家華	Jiāhuá	male person's name'
風雲人物	fēngyún rénwù	mover and shaker, popular and influential person
下決心	xià juéxīn	to resolve oneself, make up one's mind (to do something)'
//當代中文/Book 3/L08-I		
整夜	zhěngyè	(N) all night
開	kāi	(V) to turn on, to power on
燈	dēng	(N) light, lamp
電玩	diànwán	(N) video game
球賽	qiúsài	(N) ball game
激動	jīdòng	(Vs) to be excited
喊	hǎn	(Vi) to yell, shout
公職	gōngzhí	(N) government posts
其實	qíshí	(Adv) in fact, actually
公務員	gōngwù yuán	(N) civil servant
煩	fán	(Vs) a "drag", a pain in the neck
聽話	tīnghuà	(Vs-sep) to listen, to obey
失業率	shīyèlǜ	(N) unemployment rate
門	mén	(M) measure word for academic courses
讀書	dúshū	(V-sep) to study
學分	xuéfēn	(N) (academic) credits
修	xiū	(V) to take (courses)
專心	zhuānxīn	(Vs) to focus on, concentrate
修課	xiūkè	(V-sep) to take a class
輔系	fǔxì	(N) minor (in college)
瘋	fēng	(Vp) to go crazy, to be insane
誇張	kuāzhāng	(Vs) to be exaggerated
舉行	jǔxíng	(V) to hold (a conference, exhibition)
遺憾	yíhàn	(Vs) regretful (that something undesirable happened), a pity, a shame
兒子	érzi	(N) son
期望	qíwàng	(N) expectations
狀元	zhuàngyuán	(N) top-ranking in a public exam (originally the person with the highest marks on the imperial test)
努力	nǔlì	(Vs) diligent in
怎麼回事	zěnme huíshì	What's wrong?'
大喊大叫	dàhǎn dàjiào	to yell, yelling, shouting
期中考	qízhōng kǎo	mid-term exam
密集班	mìjí bān	intensive course
畢業展	bìyè zhǎn	graduation exhibition
服裝設計	fúzhuāng shèjì	fashion design
醫學系	yīxué xì	department of medicine
行行出狀元	hángháng chū zhuàngyuán	there is a leader in every industry
//當代中文/Book 3/L08-II		
冠軍	guànjūn	(N) champion, championship
大賽	dàsài	(N) a major, usually international, competition
通過	tōngguò	(Vpt) to pass
高級	gāojí	(Vs-attr) high level, advanced
碩士	shuòshì	(N) master's degree'
面試	miànshì	(N) interview
卻	què	(Adv) but, yet
國中	guózhōng	(N) junior middle school
學歷	xuélì	(N) educational background
拒絕	jùjué	(V) to reject
引起	yǐnqǐ	(Vpt) to stir up, generate, cause
彈性	tánxìng	(N) flexibility
改變	gǎibiàn	(V) to undergo change
制度	zhìdù	(N) system
基礎	jīchǔ	(N) foundation, fundamentals
認真	rènzhēn	(Vs) earnest, serious
公平	gōngpíng	(Vs) fair
出生	chūshēng	(Vp) to be born
窮	qióng	(Vs) poor
父親	fùqīn	(N) father
母親	mǔqīn	(N) mother
學徒	xuétú	(N) apprentice
吃苦	chīkǔ	(Vs-sep) experience tough times
明白	míngbái	(Vst) to understand
當兵	dāngbīng	(V-sep) to be a soldier, to do military service
認字	rènzì	(Vi) to learn characters
烘焙	hōngbèi	(V) to bake
學習	xuéxí	(V) to study
技術	jìshù	(N) skills
藝術	yìshù	(N) art
經過	jīngguò	(Prep) after
終於	zhōngyú	(Adv) finally
億	yì	(N) 100 million
夢想	mèngxiǎng	(N) dream, ideals (not during sleep)
成為	chéngwéi	(Vpt) to become
企業家	qìyèjiā	(N) entrepreneur
分店	fēndiàn	(N) branch store, branch office
原因	yuányīn	(N) reason
錄取	lùqǔ	(V) to accept (application), to admit
成功	chénggōng	(Vs) successful
鼓勵	gǔlì	(V) to encourage
吳寶春	Wú Bǎochūn	a famous baker from Taiwan
新加坡	Xīnjiāpō	Singapore
日文	Rìwén	Japanese language or writing
世界麵包大賽	shìjiè miànbāo dàsài	The Bakery World Cup
小時候	xiǎo shíhòu	in one's childhood'
大開眼界	dàkāi yǎnjiè	to have one's eyes opened'
X 分之 Y	X fēn zhī Y	pattern for indicating percentages or fractions
//當代中文/Book 3/L09-I		
訂單	dìngdān	(N) an order (trading)
客戶	kèhù	(N) customer, client
方便	fāngbiàn	(V) to offer convenience
訂購	dìnggòu	(V) to order, place an order
成立	chénglì	(V) to establish, set up
假日	jiàrì	(N) holiday
販賣	fànmài	(V) to sell
阿嬤	āmà	(N) grandma, older woman (Taiwanese)
中間商	zhōngjiānshāng	(N) middleman, reseller
經營	jīngyíng	(V) to operate, run (a business)
宅配	zháipèi	(Vi) express delivery
下	xià	(V) to place (an order)
既	jì	(Adv) not merely
隨時	suíshí	(Adv) anytime
搜尋	sōuxún	(V) to search
冰箱	bīngxiāng	(N) refrigerator (lit. ice box)
吃虧	chīkuī	(Vs-sep) to suffer a loss
比價	bǐjià	(V-sep) to compare prices, price comparison
風險	fēngxiǎn	(N) risk
賣家	màijiā	(N) seller
必須	bìxū	(Vaux) must, to have to
信用	xìnyòng	(N) credibility
萬一	wànyī	(Conj) in case
滿意	mǎnyì	(Vst) satisfied
以內	yǐnèi	(N) within
普遍	pǔbiàn	(Vs) widespread, common
選擇	xuǎnzé	(V) to choose
網購	wǎng gòu	online shopping
貨比三家不吃虧	huò bǐ sān jiā bù chīkuī	shop around and you won't get ripped off (lit. Compare products at three stores and you won't be cheated)'
兩成	liǎng chéng	20 % , literally 2/10
//當代中文/Book 3/L09-II		
鳳梨	fènglí	(N) pineapple
農產品	nóngchǎnpǐn	(N) agricultural product
出口	chūkǒu	(V) to export
曾經	céngjīng	(Adv) been the case before, once
占	zhàn	(Vst) to constitute, to account for
成本	chéngběn	(N) costs
價格	jiàgé	(N) price
競爭	jìngzhēng	(Vi) to compete against
好運	hǎoyùn	(N) good luck
內餡	nèixiàn	(N) filling (of pastries etc.)
當做	dāngzuò	(V) to treat as, to serve as
喜餅	xǐbǐng	(N) wedding-announcement pastries
喜愛	xǐ'ài	(Vst) fond of
茶點	chádiǎn	(N) snacks, dessert (served with tea)
商機	shāngjī	(N) business opportunity
代表	dàibiǎo	(V) to represent
政府	zhèngfǔ	(N) government
舉辦	jǔbàn	(V) to organize, hold
產值	chǎnzhí	(N) production value, output
提高	tígāo	(V) to increase, to elevate
知名	zhīmíng	(Vs) well known, renowned
出現	chūxiàn	(Vp) to appear
科技	kējì	(N) technology
（台）斤	(Tái) jīn	(M) catty, a unit of measure in Taiwan, equivalent to 600 grams
叔叔	shúshu	(N) uncle (father's younger brother)'
口味	kǒuwèi	(N) flavor
結果	jiéguǒ	(Adv) as a result
購買	gòumǎi	(V) to purchase
改善	gǎishàn	(V) to improve
並且	bìngqiě	(Conj) moreover
行銷	xíngxiāo	(V) to market
團購	tuángòu	(V) to group buy (for cheaper prices)
店面	diànmiàn	(N) storefront
全	quán	(Det) entire
閩南語	Mǐnnányǔ	Southern Min dialect, i.e., Taiwanese
旺來	wànglái	Southern Min sound for pineapple, lit. “abundance comes"
東京	Dōngjīng	Tokyo
鳳梨酥	fènglí sū	pineapple shortcake
第二位	dì èr wèi	second (place)
鳳梨農	fènglí nóng	pineapple farmer
//當代中文/Book 3/L10-I		
住院	zhùyuàn	(V-sep) to stay in a hospital, be hospitalized
臉	liǎn	(N) face
受傷	shòushāng	(Vp-sep) to be injured
撞	zhuàng	(V) to hit, collide
遵守	zūnshǒu	(V) to obey, follow, comply with
規則	guīzé	(N) rules, regulations
報警	bàojǐng	(V-sep) to report to (or call) the police
急診室	jízhěnshì	(N) emergency room
傷	shāng	(N) injury
骨折	gǔzhé	(Vp) to fracture, break a bone
片子	piànzi	(N) (X-ray) film
開刀	kāidāo	(V-sep) to have surgery
病人	bìngrén	(N) patient
情況	qíngkuàng	(N) situation
緊急	jǐnjí	(Vs) urgent
病床	bìngchuáng	(N) hospital bed
要命	yàomìng	(Vs) murderous, horrible
打針	dǎzhēn	(V-sep) to inject, give a shot
止痛	zhǐtòng	(Vi) to kill pain (lit. stop pain)
手術	shǒushù	(N) operation, surgery
警察	jǐngchá	(N) police
危險	wéixiǎn	(N) danger
至於	zhìyú	(Ptc) as to, regarding
部位	bùwèi	(N) (body) part, location
恢復	huīfù	(Vp) to recover
傷口	shāngkǒu	(N) wound
哎呀	āiya	(Ptc) interjection for realization of something important, oh no, yikes
出車禍	chū chēhuò	to have an automobile accident
趕時間	gǎn shíjiān	to be in a hurry
撞倒	zhuàng dǎo	to knock down, knock over
救護車	jiùhù chē	ambulance
照 X 光	zhào X guāng	to take an X-ray
動手術	dòng shǒushù	to have/undergo a surgery
//當代中文/Book 3/L10-II		
醫美	yīměi	(N) cosmetic surgery
合理	hélǐ	(Vs) reasonable
休假	xiūjià	(V-sep) to take time off
迷人	mírén	(Vs) charming, attractive
職場	zhíchǎng	(N) workplace
競爭力	jìngzhēnglì	(N) competitive edge
調查	diàochá	(N) survey, investigation
整型	zhěngxíng	(V-sep) plastic surgery
增加	zēngjiā	(V) to increase
自信	zìxìn	(N) self-confidence
外表	wàibiǎo	(N) appearance, exterior
普通	pǔtōng	(Vs) common, ordinary
從事	cóngshì	(V) to be engaged in, work in (a field of work)
醫治	yīzhì	(V) to heal, cure
一向	yíxiàng	(Adv) have always
一般	yìbān	(Vs-attr) general, most
主要	zhǔyào	(Vs-attr) primary, main
待遇	dàiyù	(N) pay
公立	gōnglì	(Vs-attr) public; government-run
外科	wàikē	(N) department of surgery
超過	chāoguò	(Vpt) to exceed
倍	bèi	(M) times, -fold
另	lìng	(Det) another, additional
價值觀	jiàzhíguān	(N) values
尊敬	zūnjìng	(Vst) to respect, respectful of
告	gào	(V) to sue, bring suit against
平均	píngjūn	(Adv) average
醫療	yīliáo	(N) medical treatment, health care
怪	guài	(V) to blame
愛林	Àilín	female person's name
微整型	wéi zhěngxíng	micro-cosmetic surgery, plastic surgery, face contouring
數一數二	shǔyī shǔ'èr	one of the top or best in..., leading…
人際關係	rénjì guānxì	interpersonal relations
動不動就	dòng bú dòng jiù	to do something impetuously
找回	zhǎo huí	to rediscover, to retrieve
//當代中文/Book 3/L11-I		
建	jiàn	(V) to build (Classical Chinese)
重建	chóngjiàn	(V) to rebuild
到底	dàodǐ	(Adv) in the end, after all
世紀	shìjì	(N) century
貿易	màoyì	(N) trade
商業	shāngyè	(N) commerce, business
利益	lìyì	(N) gains, benefit
派	pài	(V) to send, dispatch
軍隊	jūnduì	(N) army, military
燒	shāo	(V) to burn
城牆	chéngqiáng	(N) city walls, defensive walls
頭髮	tóufǎ	(N) hair
甚至	shènzhì	(Adv) even, even to the point of
打仗	dǎzhàng	(V-sep) to engage in warfare
少數	shǎoshù	(N) minority, a few
開墾	kāikěn	(V) to open up land for farming
將軍	jiāngjūn	(N) general
軍人	jūnrén	(N) military service member
平原	píngyuán	(N) flatland, plains
人口	rénkǒu	(N) population
血統	xiětǒng	(N) blood, bloodline
嘍	lou	(Ptc) a sentence-final particle meaning 'in that case''
孫子	sūnzi	(N) grandson
領土	lǐngtǔ	(N) territory (of a nation)
男性	nánxìng	(N) male
禁止	jìnzhǐ	(V) to forbid
娶	qǔ	(V) to take a woman in marriage
相信	xiāngxìn	(Vst) to believe
精彩	jīngcǎi	(Vs) splendid, brilliant as (of a performance)
紅毛城	Hóngmáo chéng	Fort Santo Domingo, lit. red-hair city
東方	Dōngfāng	the East, the Orient
淡水	Dànshuǐ	Tamsui
漢人	Hàn rén	Han-ethnic Chinese
鄭成功	Zhèng Chénggōng	Koxinga, 國姓爺 , 1624-1662, who ruled Taiwan against the Manchu sovereignty
明朝	Míng cháo	Ming Dynasty, 1368-1644
中南美洲	Zhōngnán Měizhōu	Central and South America
清朝	Qīng cháo	Qing Dynasty, 1644-1911
大清帝國	Dàqīng dìguó	the Qing Empire
輪到	lúndào	one's turn, it's up to'
十七世紀初	shíqī shìjì chū	early 17th century
打敗	dǎ bài	to defeat
十七世紀末	shíqī shìjì mò	late 17th century
//當代中文/Book 3/L11-II		
餐桌	cānzhuō	(N) dining table
中式	Zhōngshì	(N) Chinese-style
套	tào	(M) set of (books, clothes, equipment etc)
燒餅	shāobǐng	(N) clay oven sesame seed biscuits, like Indian ‘nan''
油條	yóutiáo	(N) deep-fried dough sticks
飯糰	fàntuán	(N) rice rolls with various fillings
豆漿	dòujiāng	(N) soy milk
內戰	nèizhàn	(N) civil war
人民	rénmín	(N) the people
攤子	tānzi	(N) roadside stand, vendor's stall'
菜單	càidān	(N) menu
蘿蔔	luóbo	(N) daikon radish
接著	jiēzhe	(Adv) to continue, to pick up where something left off
戰爭	zhànzhēng	(N) war
不斷	búduàn	(Vs) continual, incessant
遷移	qiānyí	(Vi) to migrate
多半	duōbàn	(Adv) mostly, in the majority of cases
困難	kùnnán	(Vs) difficult
節儉	jiéjiǎn	(Vs) frugal
主婦	zhǔfù	(N) housewife
煎	jiān	(V) to pan fry
菜色	càisè	(N) variety of dishes
以及	yǐjí	(Conj) and, as well as
美味	měiwèi	(Vs) delicious
點心	diǎnxīn	(N) desserts
日式	Rìshì	(N) Japanese-style
飲食	yǐnshí	(N) food, diet
深	shēn	(Vs) deep
蔣介石	Jiǎng Jièshí	Chiang Kai-Shek, 1887-1975
國共內戰	Guó Gòng nèizhàn	the Chinese Civil War (i.e., between the Kuomintang and the Communists), 1927-1937, 1945-1950
客家人	Kèjiā rén	the Hakka people, a branch of Han
閩南人	Mǐnnán rén	the Southern Min people, also called Hokkien
蛋餅	dàn bǐng	an egg wrap
打輸	dǎ shū	to be defeated
擺攤子	bǎi tānzi	to set up a vendor's stall'
蘿蔔糕	luóbo gāo	daikon cakes
烹飪課	pēngrèn kè	cooking class
曬乾	shài gān	to sun dry
各種各樣	gèzhǒng gèyàng	various types
殖民統治	zhímín tǒngzhì	to colonise and rule
味噌湯	wèizēng tāng	miso soup (Japanese food)
蘿蔔乾	luóbo gān	dried daikon
進一步	jìn yí bù	further
//當代中文/Book 3/L12-I		
投票	tóupiào	(V-sep) to vote
抱歉	bàoqiàn	(Vs) sorry, apologetic
表妹	biǎomèi	(N) younger female cousin
反核	fǎn hé	(Vs-attr) anti-nuclear
遊行	yóuxíng	(N) demonstration, rally
政治	zhèngzhì	(N) politics
熱衷	rèzhōng	(Vst) enthusiastic about, passionate about
前途	qiántú	(N) future, prospects
勸	quàn	(V) to persuade, to urge
而已	éryǐ	(Ptc) only, merely
民主	mínzhǔ	(Vs) democratic
表達	biǎodá	(V) to express
公共	gōnggòng	(Vs-attr) public
議題	yìtí	(N) issue
核能	hénéng	(N) nuclear power
電廠	diànchǎng	(N) power plant
由	yóu	(Prep) up to, by (a doer)
專家	zhuānjiā	(N) expert, specialist
全面	quánmiàn	(Adv) comprehensively
民意	mínyì	(N) public will, popular opinion
代表	dàibiǎo	(N) representative
處理	chǔlǐ	(V) to deal with, handle, tackle
政黨	zhèngdǎng	(N) political party
難道	nándào	(Adv) Could it be that...?, Is it that...?
滿	mǎn	(Vpt) to become
憲法	xiànfǎ	(N) constitution
投票權	tóupiào quán	(N) right to vote, suffrage
選舉	xuǎnjǔ	(N) election
權利	quánlì	(N) right
表示	biǎoshì	(V) to mean, indicate
反映	fǎnyìng	(Vpt) to reflect
為	wèi	(Prep) for
服務	fúwù	(V) to serve
職位	zhíwèi	(N) position, job
任期	rènqí	(N) term of office
選民	xuǎnmín	(N) voters, electorate
完美	wánměi	(Vs) perfect
積極	jījí	(Vs) actively, to take it upon oneself to, take the initiative to
最佳	zuìjiā	(Vs-attr) the very best, the best possible
推銷員	tuīxiāoyuán	(N) salesperson
有道理	yǒu dàolǐ	there's some truth (to what you are saying)'
候選人	hòuxuǎn rén	candidate
//當代中文/Book 3/L12-II		
學術界	xuéshùjiè	(N) academia, the academic fields or circles
從政	cóngzhèng	(Vi) to engage in politics
政策	zhèngcè	(N) policy
安定	āndìng	(Vs) stable
辭	cí	(Vp) to quit, resign
頭腦	tóunǎo	(N) brain, mind
改革	gǎigé	(N) reforms
看法	kànfǎ	(N) view, opinion
教育	jiàoyù	(N) education
方面	fāngmiàn	(N) in the areas of (an issue)
得到	dédào	(V) to obtain
連任	liánrèn	(V) to serve a successive term
屆	jiè	(M) term, tenure of elected office
支持度	zhīchídù	(N) approval rating
落選	luòxuǎn	(Vp) to lose an election
得票率	dépiàolǜ	(N) percentage of votes received
預期	yùqí	(N) expectation
暫時	zhànshí	(Adv) temporarily, for the time being (or Cn zànshí)
老家	lǎojiā	(N) hometown
形象	xíngxiàng	(N) image
商量	shāngliáng	(V) to confer, consult with
人脈	rénmài	(N) network of people, contacts
弱勢	ruòshì	(N) disadvantaged (lit. weak power)
退休	tuìxiū	(Vp) to retire
事業	shìyè	(N) business, career
捐	juān	(V) to donate
義務	yìwù	(Adv) to volunteer, on a voluntary basis, to do something gratis
經費	jīngfèi	(N) funds
競選	jìngxuǎn	(V) run for (an office)
也許	yěxǔ	(Adv) perhaps
政治界	zhèngzhìjiè	(N) the world of politics
權力	quánlì	(N) power
辭掉	cídiào	to quit, resign
提出	tíchū	to propose
國民年金	guómín niánjīn	national pension (scheme)
中間選民	zhōngjiān xuǎnmín	swing voters
一陣子	yí zhèn zi	a while, a short duration of time
下一步	xià yí bù	the next step (in doing things)
盡可能	jìn kěnéng	as far as possible, do one's best'
出版社	chūbǎn shè	publishing company
捐出	juānchū	to donate
二手書	èrshǒu shū	secondhand book
//當代中文/Book 4/L01-I		
小玲	Xiǎolíng	Xiaoling, female
阿建	Ājiàn	Ajian, male
聊天室	liáotiānshì	(N) chatroom ( 室 -shì, room)
上班族	shàngbānzú	(N) (office) workers ( 族 -zú, group)
與其	yǔqí	(Conj) rather than
冷清	lěngqīng	(Vs) deserted, empty
高就	gāojiù	(Vi) to work (honorific)
部門	bùmén	(N) department
厲害	lìhài	(Vs) impressive, good, awesome
加班	jiābān	(V-sep) to work overtime
類	lèi	(M) kind, type
恐怖片	kǒngbùpiàn	(N) horror movie ( 恐怖 kǒngbù, scary; 片 -piàn, film)
愛情片	àiqíngpiàn	(N) love story or romance movie ( 愛情 àiqíng, love)
嚇	xià	(Vp) to be scared
哭	kū	(V) to cry
上癮	shàngyǐn	(Vp) to get hooked on, addicted
刺激	cìjī	(Vs) stimulating
簡直	jiǎnzhí	(Adv) simply, really
膽子	dǎnzi	(N) guts, courage
部	bù	(M) measure word for movies
限制級	xiànzhìjí	(N) restricted (viewing for movies) ( 限制 xiànzhì, restricted; 級 -jí, level)
電影院	diànyǐngyuàn	(N) cinema, movie theater
呃	è	(Ptc) uh, interjection indicating embarrassment
建設公司	jiànshè gōngsī	construction company
業務經理	yèwù jīnglǐ	business manager
室內設計	shìnèi shèjì	interior design
//當代中文/Book 4/L01-II		
溫暖	wēnnuǎn	(Vs) warm
目前	mùqián	(Adv) currently
所	suǒ	(M) measure word for schools
就讀	jiùdú	(Vi) to be enrolled as a student
不至於	búzhìyú	(Adv) not so, not to that degree, not so much that
但	dàn	(Conj) but, however (formal)
放學	fàngxué	(Vp) after school, when school lets out
後	hòu	(N) afterwards (formal)
解決	jiějué	(V) to take care
寂寞	jímò	(Vs) lonely
網友	wǎngyǒu	(N) online friends
陪伴	péibàn	(V) to keep somebody company
電腦	diànnǎo	(N) computer
進入	jìnrù	(V) to enter
線上	xiànshàng	(N) online
感情	gǎnqíng	(N) emotions, feelings, love
小氣	xiǎoqì	(Vs) to be stingy
時	shí	(N) when (formal)
往往	wǎngwǎng	(Adv) oftentimes, generally
打氣	dǎqì	(Vi) to cheer on/up
安慰	ānwèi	(V) to comfort
心裡	xīnlǐ	(N) in (one's) mind'
大膽	dàdǎn	(Vs) to be bold, courageous
紓解	shūjiě	(V) to relieve
轉換	zhuǎnhuàn	(V) to change, transform
虛擬	xūnǐ	(Vs-attr) virtual
現實	xiànshí	(Vs) actual, real
心理	xīnlǐ	(N) psychological, mental
即使	jíshǐ	(Conj) even if, even though
責備	zébèi	(V) to reproach, get on somebody's case'
期待	qídài	(N) expectations
喘氣	chuǎnqì	(V-sep) to gasp, pant
自在	zìzài	(Vs) to be at ease, relaxed
交友	jiāoyǒu	(Vi) to make friends (with)
暴力	bàolì	(N) violence
點	diǎn	(V) to click (on)
懂得	dǒngde	(Vst) to know how to
陷阱	xiànjǐng	(N) trap, snare
明星高中	míngxīng gāozhōng	distinguished ,exclusive high school
早出晚歸	zǎochū wǎnguī	to leave home early and get home late
打開	dǎkāi	to turn on, to power on
喘不過氣	chuǎnbúguò qì	to be under great pressure, (lit.) unable to breathe
躲進	duǒjìn	to hide oneself in
掉進	diàojìn	to fall into
//當代中文/Book 4/L02-I		
李雲真	Lǐ Yúnzhēn	Li Yunzhen, female
眼睛	yǎnjīng	(N) eye
耳朵	ěrduo	(N) ear
饗宴	xiǎngyàn	(N) feast
打扮	dǎbàn	(V) to put on makeup
音樂廳	yīnyuètīng	(N) music hall, concert hall ( 廳 -tīng, hall)
表演	biǎoyǎn	(N/V) performance; to perform
整齊	zhěngqí	(Vs) neat
穿著	chuānzhuó	(N) attire
丟臉	diūliǎn	(Vs-sep) to lose face, to be embarrassed
短褲	duǎnkù	(N) shorts
涼鞋	liángxié	(N) sandals
擋	dǎng	(V) to block
演出者	yǎnchūzhě	(N) performer ( 演出 yǎnchū, to perform; 者 zhě, person)
尊重	zūnzhòng	(Vst) to respect
社交	shèjiāo	(N) socialization
免得	miǎnde	(Conj) lest, so as not to, to avoid
中場	zhōngchǎng	(N) intermission, halftime
準時	zhǔnshí	(Vs) to be punctual, on time
禮貌	lǐmào	(N) courtesy
或	huò	(Conj) or (formal)
熟	shóu	(Vs) to be familiar with, to be close to somebody
提	tí	(V) to bring up, mention
咳嗽	késòu	(Vi) to cough
關	guān	(V) to close, shut off
哇	wa	(Ptc) yikes, oh no
水準	shuǐzhǔn	(N) class, cultural standard
手冊	shǒucè	(N) programme, manual
洗手間	xǐshǒujiān	(N) restroom ( 間 -jiān, part of 房間 , room)
提醒	tíxǐng	(V) to remind
響	xiǎng	(Vp) to sound
糟	zāo	(Vs) awful
噓	xū	(Ptc) Shh, to hush
看不成	kànbùchéng	to miss out
聯絡感情	liánluò gǎnqíng	to get to know each other better, to strengthen ties with each other
擤鼻涕	xǐng bítì	to blow one's nose'
//當代中文/Book 4/L02-II		
場	chǎng	(M) measure word for performances
強調	qiángdiào	(V) to stress
團體	tuántǐ	(N) group
千萬	qiānwàn	(Adv) by all means
鋼琴	gāngqín	(N) piano
小提琴	xiǎotíqín	(N) violin
古典	gǔdiǎn	(Vs) classical
畫家	huàjiā	(N) painter
畫	huà	(V/N) to paint; painting
舞蹈	wǔdào	(N) dance
文學	wénxué	(N) literature
繪畫	huìhuà	(N) (act of) painting, drawing
等	děng	(Ptc) etc., and so forth
寺廟	sìmiào	(N) temple
表現	biǎoxiàn	(V/N) to manifest, express; manifestation, expression
之	zhī	(Ptc) of (from classical Chinese, roughly equivalent to the modern Chinese 的 )
劇情	jùqíng	(N) story, plot, storyline
導演	dǎoyǎn	(N) director (movies)
所	suǒ	(Ptc) a verbal marker (marking what comes after as a verb)
紅	hóng	(Vs) popular (of an actress or singer)
明星	míngxīng	(N) movie stars
演技	yǎnjì	(N) acting skills
得	dé	(Vpt) to get, obtain, receive
獎	jiǎng	(N) award
廣場	guǎngchǎng	(N) plaza
或	huò	(Conj) or
仔細	zǐxì	(Adv) carefully, attentively
留意	liúyì	(Vst) to pay attention to, take note of
處處	chùchù	(Adv) everywhere
滿足	mǎnzú	(Vst) to satisfy
豐盛	fēngshèng	(Vs) sumptuous, abundant
國家戲劇院	Guójiā Xìjùyuàn	National Theater
雲門舞集	Yúnmén Wǔjí	Cloud Gate Dance Theatre
國家音樂廳	Guójiā Yīnyuètīng	National Concert Hall
金馬影展	Jīnmǎ Yǐngzhǎn	Golden Horse Film Festival
現代舞	xiàndài wǔ	modern dance
無人不知無人不曉	wúrén bùzhī wúrén bùxiǎo	known to all
百聞不如一見	bǎiwén bùrú yíjiàn	seeing it once is better than hearing about it a hundred times
老街	lǎojiē	old street
街頭藝術	jiētóu yìshù	street art
裝置藝術	zhuāngzhì yìshù	installation art
填飽	tiánbǎo	to fill one's belly'
口腹之慾	kǒufù zhīyù	the desire of one's palate'
//當代中文/Book 4/L03-I		
李文麗	Lǐ Wénlì	Li Wenli, female
外婆	wàipó	(N) grandma
女裝	nǚzhuāng	(N) women's apparel'
何必	hébì	(Adv) Why bother..., Why must?
指	zhǐ	(Vst) to mean, to indicate
划算	huásuàn	(Vs) cost effective, a good deal
身材	shēncái	(N) figure, build, body (shape)
模特兒	mótèr	(N) model
不見得	bújiàndé	(Adv) not necessarily
仿冒品	fǎngmàopǐn	(N) knock-off, counterfeit product (仿冒 fǎngmào, counterfeit; 品 -pǐn, product)
瑕疵	xiácī	(N) defect
圖片	túpiàn	(N) picture
落差	luòchā	(N) difference
提供	tígōng	(V) to offer
資訊	zīxùn	(N) information
疑問	yíwèn	(N) question, doubt
嘛	ma	(Ptc) sentence particle, ‘it is obvious that''
慣	guàn	(Ptc) to get used to, accustomed to etc…
瀏覽	liúlǎn	(V) to browse, surf (the internet)
後悔	hòuhuǐ	(Vs) to regret, feel sorrowful about
深夜	shēnyè	(N) late at night, in the wee hours
任何	rènhé	(Det) any
駭客	hàikè	(N) hacker
盜用	dàoyòng	(V) to hack, use illegitimately
認證	rènzhèng	(V/N) to certify; certification
銀髮族	yínfǎzú	(N) senior citizens, seniors (銀 yín, silver; 髮 fǎ, hair)
從前	cóngqián	(N) in the past, before, formerly
通常	tōngcháng	(Adv) generally, as a rule
取貨	qǔhuò	(V-sep) to pick up goods
付款	fùkuǎn	(V-sep) to make payment
雲端科技	yúnduānkējì	cloud/internet technology
宅經濟	zháijīngjì	online economy
用不慣	yòngbúguàn	not used/accustomed to using, not comfortable with
退換	tuì huàn	to return, to exchange for something else
信用卡	xìnyòng kǎ	credit card
//當代中文/Book 4/L03-II		
縮短	suōduǎn	(Vpt) to shorten
人們	rénmen	(N) people in general
距離	jùlí	(N) distance
取代	qǔdài	(V) to replace
信	xìn	(N) letter, mail
影集	yǐngjí	(N) (TV) series
取得	qǔdé	(V) to obtain, access
例如	lìrú	(Vst) for example
民眾	mínzhòng	(N) the public, people in general
高速公路	gāosù gōnglù	(N) highway, freeway
前	qián	(N) before (formal)
查詢	cháxún	(V) to look up, check
路況	lùkuàng	(N) road situation, traffic situation
避開	bìkāi	(V) to avoid
路段	lùduàn	(N) section of road
若	ruò	(Conj) if, supposing
運用	yùnyòng	(V) to use, employ
病歷	bìnglì	(N) medical records
例子	lìzi	(N) example
更加	gèngjiā	(Adv) even more
原本	yuánběn	(Adv) originally
忙碌	mánglù	(Vs) busy
確實	quèshí	(Adv) indeed
控制	kòngzhì	(V) to control
表弟	biǎodì	(N) cousin (younger male cousin from one's mother's side as well as from one's father's sisters)'
退步	tuìbù	(Vp) to regress, get worse, fall behind
過度	guòdù	(Adv) overly, excessively
與	yǔ	(Conj) and (formal)
生理	shēnglǐ	(N) physical health
盯	dīng	(V) to stare
螢幕	yíngmù	(N) screen, monitor
疲倦	píjuàn	(Vs) tired, fatigued
視力	shìlì	(N) vision, eyesight
家長	jiāzhǎng	(N) parent
此外	cǐwài	(Conj) in addition
戶外	hùwài	(N) outdoor
人類	rénlèi	(N) mankind, humans
正面	zhèngmiàn	(Vs) positive
同時	tóngshí	(Adv) at the same time
負面	fùmiàn	(Vs) negative
沉迷	chénmí	(Vs) to be obsessed with, wallow in
無形中	wúxíng zhōng	imperceptibly
遠距教學	yuǎnjù jiāoxué	distance learning
大吵大鬧	dàchǎo dànào	to kick up a row, make a scene, scream bloody murder
焦慮不安	jiāolǜ bù'ān'	to be anxious
總而言之	zǒng'ér yánzhī'	in conclusion, to sum up, in short
//當代中文/Book 4/L04-I		
該	gāi	(Vaux) should, ought to
擺	bǎi	(V) to place, display
總算	zǒngsuàn	(Adv) finally
欸	èi	(Ptc) hey, calling attention
呀	yā	(Ptc) particle indicating uncertainty
衣櫥	yīchú	(N) closet
梳妝台	shūzhuāngtái	(N) dressing table
位置	wèizhì	(N) position, location
空間	kōngjiān	(N) space
科學	kēxué	(N) science
風水師	fēngshuǐshī	(N) Feng Shui master, geomancer ( 風水 fēngshuǐ, Feng Shui; 師 -shī, master)
在意	zàiyì	(Vs) to care about
所謂	suǒwèi	(V) so-called, what is known as
角度	jiǎodù	(N) angle, perspective
改造	gǎizào	(V) to transform, restructure
學問	xuéwèn	(N) a branch of learning
居住	jūzhù	(Vi) to live, reside
日常	rìcháng	(Vs-attr) daily
布置	bùzhì	(N/V) décor, layout, arrangement; to decorate, to arrange furniture
凶猛	xiōngměng	(Vs) fierce, ferocious
動物	dòngwù	(N) animal
刀	dāo	(N) knife
劍	jiàn	(N) sword
脾氣	píqì	(N) temper
暴躁	bàozào	(Vs) cranky, irritable
衝動	chōngdòng	(Vs) impulsive, rash
鏡子	jìngzi	(N) mirror
床腳	chuángjiǎo	(N) foot of the bed
光	guāng	(Adv) alone, merely
擺飾	bǎishì	(N) décor, ornaments
老婆	lǎopó	(N) wife
把	bǎ	(M) measure word for objects that can be grasped or objects with a handle, e.g., umbrella, knife
欺負	qīfù	(V) to pick on, bully, take advantage of
風水學	Fēngshuǐxué	the study of Feng Shui, geomancy ( 學 -xué, -ology) study,
正對門	zhèng duì mén	directly facing the door
譬如說	pìrú shuō	for example
一口氣	yì kǒu qì	in one breath
死定了	sǐdìngle	(You're) a dead man, You're toast'
//當代中文/Book 4/L04-II		
地理	dìlǐ	(N) geography
便利性	biànlìxìng	(N) convenience ( 性 -xìng, property, suffix indicating that a term is a noun)
周邊	zhōubiān	(N) surrounding, periphery
住宅	zhùzhái	(N) residence
詞	cí	(N) term,word
西元	Xīyuán	(N) A.D.
推翻	tuīfān	(V) to repudiate, overturn
心中	xīnzhōng	(N) in somebody's heart'
名言	míngyán	(N) well-known saying
建造	jiànzào	(V) to build
塑造	sùzào	(V) to shape
命運	mìngyùn	(N) fate, destiny
本身	běnshēn	(N) itself, oneself
地標	dìbiāo	(N) landmark
參考	cānkǎo	(V/N) to make reference to; reference
外觀	wàiguān	(N) exterior, appearance
疊	dié	(V) to stack
盆子	pénzi	(N) basin
斜	xié	(Vs) slanted, tilted
牆面	qiángmiàn	(N) wall face
聚寶盆	jùbǎopén	(N) treasure basin, similar to a cornucopia but filled with treasure ( 聚 -jù, to gather; 寶 -bǎo, treasure; 盆 -pén, basin)
角	jiǎo	(N) corner
龍	lóng	(N) dragon
古	gǔ	(Vs-attr) ancient (formal)
錢幣	qiánbì	(N) coins,currency
屋頂	wūdǐng	(N) roof
龜	guī	(N) turtle, tortoise
招財	zhāocái	(Vi) to attract treasure
側門	cèmén	(N) side door, side gate
遮雨棚	zhēyǔpéng	(N) canopy, awning
如意	rúyì	(N) ruyi, scepter, s-shaped ornamental object that brings good luck
設計	shèjì	(N/V) design; to design
偶然	ǒurán	(Vs) random, accidental, chancy
晉代	Jìn Dài	Jin Dynasty
郭璞	Guō Pú	Guo Pu
英國	Yīngguó	the UK
邱吉爾	Qiūjí'ěr'	Churchill
信義路	Xìnyì Lù	Xinyi Road
松智路	Sōngzhì Lù	Songzhi Road
一命二運三風水	yímìng èryùn sānfēngshuǐ	Fate is most important. Luck is second. Feng Shui is third.
加起來	jiāqǐlái	to add up, totalize
咬錢龜	yǎoqián guī	money-biting turtle
十全十美	shíquán shíměi	perfect, pinnacle of perfection
//當代中文/Book 4/L05-I		
夢	mèng	(N) dream
排隊	páiduì	(V-sep) to line up, stand in queue
校刊	xiàokān	(N) school newspaper, school publications of all sorts
採訪	cǎifǎng	(V) to interview
校友	xiàoyǒu	(N) alumnus
博士	bóshì	(N) doctorate, PhD
學位	xuéwèi	(N) academic degree
考	kǎo	(V) to take a test
司機	sījī	(N) driver, chauffeur
學士	xuéshì	(N) bachelor's, college degree'
地攤	dìtān	(N) street stall
現象	xiànxiàng	(N) phenomenon
稀奇	xīqí	(Vs) rare (and unique), singular
搶	qiǎng	(V) to rob, mug
批評	pīpíng	(V) to criticize
浪費	làngfèi	(Vst) to waste
畢竟	bìjìng	(Adv) after all
貢獻	gòngxiàn	(V) to make contributions
的確	díquè	(Adv) indeed
盲目	mángmù	(Adv) blindly
升學	shēngxué	(Vi) to pursue further education
逃避	táobì	(V) to evade, escape
就業	jiùyè	(N/Vi) employment; to get a job
延後	yánhòu	(V) to postpone
啃老族	kěnlǎozú	(N) a “sponge”, a “parasite”, somebody who feeds off the old (啃老 kěnlǎo, gnaw on the old) live off one's parents, lit. gnaw on the old)'
收攤	shōutān	(V-sep) to close up shop (said of street stalls)
清潔隊員	qīngjiéduìyuán	cleaning squad, street cleaners ( 清潔 qīngjié, to clean; 隊員 -duìyuán, team member)
擺地攤	bǎi dìtān	to have a street stall
大多數	dàduōshù	most, the majority of
話說回來	huàshuō huílái	on the other hand, however
自食其力	zìshí qílì	to rely on yourself, to stand on your own two feet
下一期	xiàyìqí	next issue (of a periodical)
//當代中文/Book 4/L05-II		
段	duàn	(M) a period of (time)
物價	wùjià	(N) prices, commodity prices
上漲	shàngzhǎng	(Vp) to rise (of prices)
所得	suǒdé	(N) income
漲	zhǎng	(Vp) to rise (as of prices and water level)
勉強	miǎnqiǎng	(Adv) barely, with great reluctance
根本	gēnběn	(Adv) at all, in the slightest
組織	zǔzhī	(N) organization
抗議	kàngyì	(V) to protest against
地價	dìjià	(N) land prices
房價	fángjià	(N) housing prices
高漲	gāozhǎng	(Vs) to (upward) surge
造成	zàochéng	(Vpt) to cause, produce, make
統計	tǒngjì	(N) statistics
窮忙	qióngmáng	(Vs) busy doing things without achieving anything
全球	quánqiú	(N) global, worldwide
景氣	jǐngqì	(Vs) prosperous, booming, economic conditions
施行	shīxíng	(V) to implement, put into effect
薪資	xīnzī	(N) pay, salary, wages
多年	duōnián	(N) for many years, for so long
未	wèi	(Adv) not yet (formal)
調高	tiáogāo	(V) to adjust upward
裁員	cáiyuán	(Vi) to lay off
觀察	guānchá	(V) to observe, note
彩券	cǎiquàn	(N) lottery
中獎	zhòngjiǎng	(Vp-sep) to win (a prize or lottery), to hit a jackpot
做夢	zuòmèng	(V-sep) to dream
發財	fācái	(Vp-sep) to strike it rich
臉色	liǎnsè	(N) countenance (mood shown on face)
報導	bàodǎo	(N) report, article, story (news)
指出	zhǐchū	(V) to indicate, point out
創業	chuàngyè	(Vi) to set up a business
餐飲業	cānyǐnyè	(N) food and beverage industry
人生	rénshēng	(N) life
及	jí	(Conj) and (formal)
挑戰	tiǎozhàn	(N) challenge
培養	péiyǎng	(V) to cultivate, train, foster
實力	shílì	(N) strength (not physical strength)
等待	děngdài	(V) to wait for, await
擁有	yǒngyǒu	(Vst) to have as one's own, possess'
中國大陸	Zhōngguó Dàlù	Mainland China
存不了	cúnbùliǎo	can't save (money)'
無殼蝸牛	wúké guāniú	"snails without shells" (people who can't afford to buy their own home)'
貧富不均	pínfù bùjūn	gap between the rich and the poor, unequal distribution of wealth
苦哈哈	kǔ hāhā	bitter life, very poorly
另謀發展	lìngmóu fāzhǎn	to seek opportunities elsewhere
恨不得	hènbùdé	to be dying to, desperately
一夜致富	yíyè zhìfù	to become rich overnight
一片天	yípiàntiān	place in the sun, a job that makes you happy and provides you with all the money and things that you want, paradise
//當代中文/Book 4/L06-I		
高來恩	Gāo Lái'ēn'	a man from Switzerland
地震	dìzhèn	(N) earthquake
搖	yáo	(Vp) to rock, shake
厲害	lìhài	(Vs) fierce, formidable
經常	jīngcháng	(Adv) frequently
倒	dǎo	(Vp) to collapse
橋	qiáo	(N) bridge
斷	duàn	(Vp) to break, snap
多	duó	(Adv) so
地區	dìqū	(N) region
強烈	qiángliè	(Vs) strong
頻率	pínlǜ	(N) frequency
預測	yùcè	(V) to predict, forecast
徵兆	zhēngzhào	(N) sign, omen
鳥類	niǎolèi	(N) birds
雞	jī	(N) chicken
預先	yùxiān	(Adv) in advance
老鼠	lǎoshǔ	(N) mouse, rat
貓	māo	(N) cat
馬	mǎ	(N) horse
證實	zhèngshí	(V) to verify
應變	yìngbiàn	(Vi) to meet an emergency
隨手	suíshǒu	(Adv) within easy reach
白	bái	(Adv) in vain
嫌	xián	(Vst) to grumble
事前	shìqián	(Adv) in advance
總是	zǒngshì	(Adv) always
西歐	Xī Ōu	Western Europe
北歐	Běi Ōu	Northern Europe
中歐	Zhōng Ōu	Central Europe
澳洲	Àozhōu	Australia
南美洲	Nán Měizhōu	South America
地球科學	dìqiú kēxué	earth science studies
菲律賓	Fēilǜbīn	the Philippines
天搖地動	tiānyáo dìdòng	swaying heavens and trembling earth, earth-shaking
壓死	yāsǐ	crushed to death
災情慘重	zāiqíng cǎnzhòng	in serious disaster
東半部	dōngbànbù	the eastern half
地震帶	dìzhèn dài	seismic zone, earthquake belt
救生包	jiùshēng bāo	survival kit, survival pack
有備無患	yǒubèi wúhuàn	be prepared, be on the safe side
//當代中文/Book 4/L06-II		
如何	rúhé	(Adv) how
逃生	táoshēng	(Vi) to evacuate
發達	fādá	(Vs) advanced, developed
天災	tiānzāi	(N) natural disaster
災害	zāihài	(N) disaster, damage (from a disaster)
程度	chéngdù	(N) degree, level
首先	shǒuxiān	(Adv) first of all
其次	qícì	(Adv) second, next, then
災難	zāinàn	(N) disaster
緊急	jǐnjí	(Vs) in emergency
必需品	bìxūpǐn	(N) necessities ( 必需 bìxū, essential, indispensable)
譬如	pìrú	(Vst) for example, like
手電筒	shǒudiàntǒng	(N) flashlight, torch
餅乾	bǐnggān	(N) crackers, cookies
平時	píngshí	(N) in ordinary times
狀況	zhuàngkuàng	(N) situation,circumstance
慌張	huāngzhāng	(Vs) to panic, be flustered
停電	tíngdiàn	(Vp-sep) to have a power outage
黑暗	hēi'àn'	(N) the darkness
方向	fāngxiàng	(N) direction
集合	jíhé	(Vi) to meet, assemble
裂縫	lièfèng	(N) crack
瓦斯	wǎsī	(N) natural gas
開關	kāiguān	(N) switch
火災	huǒzāi	(N) fire (disaster), conflagration
門框	ménkuāng	(N) door frame
歪	wāi	(Vp) askew, slanted, crooked
頭部	tóubù	(N) head
冷靜	lěngjìng	(Vs) cool-headed, calm
穩	wěn	(Vs) steady
櫃子	guìzi	(N) closet, cabinet
牆壁	qiángbì	(N) wall
倒塌	dǎotā	(Vp) to collapse
電梯	diàntī	(N) elevator
反而	fǎn'ér'	(Conj) on the contrary, rather
堅固	jiāngù	(Vs) strong, firm, solid
柱子	zhùzi	(N) pillar, column
碰	pèng	(V) to hit, bump into
形成	xíngchéng	(V) to form
三角形	sānjiǎoxíng	(N) triangle
保持	bǎochí	(V) to remain, stay
平靜	píngjìng	(Vs) calm
指示	zhǐshì	(N) instructions, commands
救援	jiùyuán	(Vi) to rescue
行動	xíngdòng	(N) activity, action, operations
掉下來	diàoxiàlái	to fall down, to drop
倒下來	dǎoxiàlái	to fall over, to collapse
救災人員	jiùzāi rényuán	rescue personnel
//當代中文/Book 4/L07-I		
博文	Bówén	a senior in college
玉珍	Yùzhēn	a sophomore in college
學妹	xuémèi	(N) female lower classmate (see culture notes)
學弟	xuédì	(N) male lower classmate
彈	tán	(V) to play (piano, guitar)
吉他	jítā	(N) guitar
交	jiāo	(V) to submit, hand in
家教	jiājiào	(N) coach, tutor
學長	xuézhǎng	(N) male upper classmate
還	hái	(Adv) to one's surprise'
進度	jìndù	(N) progress
落後	luòhòu	(Vp) to fall behind, lag
完成	wánchéng	(Vpt) to complete
一連	yìlián	(Adv) in a row, in succession
約會	yuēhuì	(V-sep) to make a date/appointment
一生	yìshēng	(N) (for) one's life'
時光	shíguāng	(N) time
倒流	dàoliú	(Vp) to flow backward
加強	jiāqiáng	(V) to strengthen
至少	zhìshǎo	(Adv) at least
訓練	xùnliàn	(N/V) training; to train
外國	wàiguó	(N) other countries, abroad, foreign
爭取	zhēngqǔ	(V) to vie for, compete for
實習	shíxí	(Vi) to intern
二分之一	èrfēn zhīyī	1/2
一下...一下...	yíxià...yíxià...	measure phrase, describing fast-changing alternating scenes of two activities
到時候	dào shíhòu	at that time, when the time comes
談戀愛	tán liàn ài	to be in love, go steady (said of dating couples)
低空飛過	dīkōng fēiguò	barely managed to pass (a test, course)
有助於	yǒuzhùyú	to help in something, be beneficial to something
寒暑假	hánshǔ jià	winter and summer vacations
//當代中文/Book 4/L07-II		
暗戀	ànliàn	(V) to have a crush on someone
目光	mùguāng	(N) eyes, gaze
移動	yídòng	(Vi) to move
於是	yúshì	(Conj) so, whereupon
原來	yuánlái	(Adv) the truth is
煩惱	fánnǎo	(Vs) to be troubled, vexed
擔任	dānrèn	(V) to hold the post of
學生會	xuéshēnghuì	(N) student union ( 會 -huì, organization)
會長	huìzhǎng	(N) president of an association, club etc... ( 長 -zhǎng, head)
校隊	xiàoduì	(N) school team
隊員	duìyuán	(N) team member ( 員 -yuán, member, person)
高大	gāodà	(Vs) tall and big, bulky
帥氣	shuàiqì	(Vs) dashing, handsome
雙	shuāng	(M) a pair of
開朗	kāilǎng	(Vs) cheerful
微笑	wéixiào	(Vi) to smile
情人節	qíngrénjié	(N) Valentine's Day ( 節 -jié, holiday, day)'
親手	qīnshǒu	(Adv) personally, with one's own hands'
巧克力	qiǎokèlì	(N) chocolate
當天	dāngtiān	(N) that day
堆	duī	(M) a pile of
向	xiàng	(Prep) to
告白	gàobái	(Vi) to confess
萬人迷	wànrénmí	(N) heartthrob ( 迷 -mí, charmer)
交往	jiāowǎng	(Vi) to go steady, to date
系花	xìhuā	(N) department beauty, the most beautiful girl in a department
追	zhuī	(V) to chase, woo
情書	qíngshū	(N) love letter
態度	tàidù	(N) attitude
曖昧	àimèi	(Vs) ambiguous (about one's relationship)'
甜蜜	tiánmì	(Vs) sweet
溫柔	wēnróu	(Vs) tender
訊息	xùnxí	(N) message
忌妒	jìdù	(Vst) to be jealous
安全感	ānquángǎn	(N) the feeling of security ( 感 -gǎn, sense/feeling of)
吃醋	chīcù	(Vp-sep) to be jealous
吵架	chǎojià	(V-sep) to quarrel, fight, argue
牽	qiān	(V) to hold
吻	wěn	(V) to kiss
劈腿	pītuǐ	(Vp-sep) to two-time
糟糕	zāogāo	(Ptc) oh no, how terrible, what bad luck!
何清源	Hé Qīngyuán	a male college student
林榮華	Lín Rónghuá	a male college student
一見鍾情	yíjiàn zhōngqíng	love at first sight
一舉一動	yìjǔ yídòng	every move
前一天	qián yì tiān	the day before
已讀不回	yǐdú bùhuí	read without reply
//當代中文/Book 4/L08-I		
王麗華	Wáng Lìhuá	a woman from Taiwan
魯亞	Lǔ Yǎ	a man from Turkey
論文	lùnwén	(N) thesis, dissertation, scholarly article
反正	fǎnzhèng	(Adv) in any case
不只	bùzhǐ	(Adv) not only
哈	hā	(Ptc) ha
代替	dàitì	(V) to substitute, to be in place of
獨自	dúzì	(Adv) alone, by oneself
難免	nánmiǎn	(Adv) inevitably, hard to avoid
費用	fèiyòng	(N) costs, expense
觀念	guānniàn	(N) concept, notion
代	dài	(N) generation
婚姻	hūnyīn	(N) marriage
束縛	shùfú	(V) to be fettered by, bound by, shackled by
追求	zhuīqiú	(V) to pursue
倒是	dàoshì	(Adv) on the other hand
推行	tuīxíng	(V) to promote
生育	shēngyù	(V/N) to have babies; reproduction, childbirth
補助	bǔzhù	(V/N) to subsidize; subsidy, allowance
老人	lǎorén	(N) old people, seniors
夫婦	fūfù	(N) husband and wife, couple ( 夫 -fū, man; 婦 fù, woman)
獨生子	dúshēngzǐ	(N) only child (male)
寵	chǒng	(Vst) to spoil (somebody)
職業	zhíyè	(N) occupation, profession
婦產科	fùchǎnkē	(N) obstetrics and gynecology, OB/GYN ( 婦 -fù, woman; 產 -chǎn, produce; 科 -kē, department)
失業	shīyè	(Vp) to lose one's job, to become unemployed'
補習班	bǔxíbān	(N) cram school ( 補習 bǔxí, supplement studies; 班 -bān, class)
不可思議	bùkě sīyì	hard to comprehend, beyond logic, unbelievable
有話直說	yǒuhuà zhíshuō	to be frank, don't hold anything back, spit it out'
娃娃推車	wáwa tuīchē	baby carriage
不足為奇	bùzú wéiqí	nothing strange, not surprising at all
遠遠	yuǎnyuǎn	by far
傳宗接代	chuánzōng jiēdài	carry on the family line
無拘無束	wújū wúshù	carefree, free, do as one pleases
老一輩	lǎoyíbèi	the older generation
一胎化政策	yìtāihuà zhèngcè	One Child Policy
這下子	zhèxiàzi	as a consequence
//當代中文/Book 4/L08-II		
已	yǐ	(Adv) already (formal)
生育率	shēngyùlǜ	(N) birth rate ( 率 -lǜ, rate)
離婚	líhūn	(Vp-sep) to get divorced
年齡	niánlíng	(N) age
較	jiào	(Adv) comparatively more (formal)
使	shǐ	(Vst) to cause
行業	hángyè	(N) businesses, walks of life
重大	zhòngdà	(Vs) enormous, heavy
幼稚園	yòuzhìyuán	(N) kindergarten
招生	zhāoshēng	(Vi) to recruit students, find students
減班	jiǎnbān	(Vp-sep) to reduce enrollments
將	jiāng	(Adv) will soon
少子化	shǎozǐhuà	(Vp) low birth rate ( 少 , few; 子 , children; 化 huà, -ize, suffix indicating transformation)
連鎖	liánsuǒ	(Vs-attr) chain, franchise
兒童	értóng	(N) child (ren)
美語	Měiyǔ	(N) (American) English
倒閉	dǎobì	(Vp) to go out of business
何況	hékuàng	(Adv) much less, let alone
無法	wúfǎ	(Adv) to be unable to
未來	wèilái	(N) future
遠景	yuǎnjǐng	(N) future prospects
足夠	zúgòu	(Vs) enough
加入	jiārù	(V) to enter, join
老化	lǎohuà	(Vp) aging
針對	zhēnduì	(Prep) aimed at, directed at
項	xiàng	(M) item
措施	cuòshī	(N) measure
減稅	jiǎnshuì	(V-sep) to reduce taxes, tax break
延長	yáncháng	(V) to extended, make longer
產假	chǎnjià	(N) maternity leave
托育	tuōyù	(N) childcare
胎	tāi	(N) embryo, birth, child
領	lǐng	(V) to receive, withdraw (money)
元	yuán	(N) dollar (or other currency)
成年	chéngnián	(Vp) to come to age, enter adulthood
除非	chúfēi	(Conj) unless
整體	zhěngtǐ	(N) overall
否則	fǒuzé	(Conj) otherwise
婦女	fùnǚ	(N) woman
意願	yìyuàn	(N) intention
祖父母	zǔfùmǔ	(N) paternal grandparents
孫女	sūnnǚ	(N) granddaughter
重	zhòng	(Vs) heavy
預算	yùsuàn	(N) budget
財政	cáizhèng	(N) finance
沉重	chénzhòng	(Vs) heavy
有效	yǒuxiào	(Vs) effective
正	zhèng	(Adv) during the process of
考驗	kǎoyàn	(V) to test out
智慧	zhìhuì	(N) wisdom
之一	zhīyī	one of
寧缺勿濫	níngquē wùlàn	not settle for less than perfect
合不來	hébùlái	not get along
生兒育女	shēng'ér yùnǚ'	to have and raise children
獨善其身	dúshàn qíshēn	to look out only for oneself, be self-centered
停滯不前	tíngzhì bùqián	in stagnation
//當代中文/Book 4/L09-I		
逐漸	zhújiàn	(Adv) gradually
據點	jùdiǎn	(N) base, stronghold
統治	tǒngzhì	(V) to rule, govern
景點	jǐngdiǎn	(N) scenic site
繁榮	fánróng	(Vs) prosperous
港口	gǎngkǒu	(N) harbor, port
據說	jùshuō	(V) it is said
鹿	lù	(N) deer
鹿群	lùqún	(N) herd of deer ( 群 -qún, group, crowd)
形狀	xíngzhuàng	(N) shape
鹿角	lùjiǎo	(N) deer antlers
便	biàn	(Adv) accordingly
稱	chēng	(V) to call
動物園	dòngwùyuán	(N) zoo
皮	pí	(N) skin, hides
殺	shā	(V) to kill
數量	shùliàng	(N) number, quantity
風光	fēngguāng	(N) glory
民宅	mínzhái	(N) home, people's residence'
蚵仔煎	ézǐjiān	(N) oyster omelet
哦	ó	(Ptc) an interjection indicating concurrence accepting what has been presented
該	gāi	(Vaux) should, ought to (formal)
興盛	xīngshèng	(Vs) flourishing
時期	shíqí	(N) period, age
獨木舟	dúmùzhōu	(N) canoe
為	wéi	(Vst) as
載運	zàiyùn	(V) to transport
改名	gǎimíng	(V-sep) to legally change one's names'
相似	xiāngsì	(Vs) similar
沒落	mòluò	(Vp) to decline, wane
依然	yīrán	(Adv) still
保留	bǎoliú	(V) to remain intact, preserve
鹿港	Lùgǎng	Lugang
艋舺	Měngjiǎ	Mengjia (Mangka)
淡水河	Dànshuǐ Hé	Tamsui River ( 河 hé,river)
萬華	Wànhuá	Wanhua
台語	Táiyǔ	Taiwanese (a Southern Min dialect)
日語	Rìyǔ	Japanese (language)
家喻戶曉	jiāyù hùxiǎo	widely known
滿山遍野	mǎnshān biànyě	all over the mountains and plains
古色古香	gǔsè gǔxiāng	to have an antique air, quaint, classical in style
綠豆糕	lǜdòu gāo	mung-bean cake
牛舌餅	niúshé bǐng	ox-tongue biscuit
垂涎三尺	chuíxián sānchǐ	to salivate over, make one's mouth water'
//當代中文/Book 4/L09-II		
數目	shùmù	(N) amount, quantity
大約	dàyuē	(Adv) about, approximately
佔	zhàn	(Vst) constitute (same as “ 占” )
自從	zìcóng	(Prep) ever since
將近	jiāngjìn	(Adv) nearly, almost
往來	wǎnglái	(N) dealings, contact
思念	sīniàn	(Vst) to miss, think about, long for
通信	tōngxìn	(V-sep) to communicate, correspond by mail
毫無	háowú	(Vst) none whatsoever
音訊	yīnxùn	(N) news, information, message
遠離	yuǎnlí	(Vst) to have left far away from
妻子	qīzi	(N) wife (literary)
永遠	yǒngyuǎn	(N) always, forever
開放	kāifàng	(Vp) to open to the public
探親	tànqīn	(Vi) to visit relatives
親人	qīnrén	(N) relatives, loved ones
打聽	dǎtīng	(V) to ask about, inquire
不禁	bùjīn	(Adv) can't help but'
淚	lèi	(N) tears
尚未	shàngwèi	(Adv) not yet
出世	chūshì	(Vp) to be born
童年	tóngnián	(N) childhood
傷心	shāngxīn	(Vs) sad
筆	bǐ	(M) sum (of money)
仍然	réngrán	(Adv) still
原諒	yuánliàng	(Vst) to forgive
盡	jìn	(V) to exhaust, do one's utmost'
究竟	jiùjìng	(Adv) after all, in the end, actually
內心	nèixīn	(N) in one's heart, heart of hearts, innermost being'
創傷	chuāngshāng	(N) trauma, scars
珍惜	zhēnxí	(Vst) to cherish, treasure
精華	jīnghuá	(Vs-attr) prime
逃難	táonàn	(Vi) to flee from war, natural disaster etc
實在	shízài	(Adv) truly, really
歲月	suìyuè	(N) years, time
遭遇	zāoyù	(N/V) (unhappy) experiences, happenings; to encounter, to have met with
老兵	lǎobīng	(N) old soldier, veteran
老張	Lǎo Zhāng	Lao Zhang, a nickname for someone whose surname is Zhang
文化大革命	Wénhuà Dà Gémìng	Cultural Revolution (1966 ~ 1976)
落地生根	luòdì shēnggēn	to set one's roots down'
身強體壯	shēnqiáng tǐzhuàng	strong and healthy
離鄉背井	líxiāng bèijǐng	to leave one's hometown to become a stranger elsewhere'
飄洋過海	piāoyáng guòhǎi	to sail cross the sea
朝思暮想	zhāosī mùxiǎng	to be amiss day and night
一輩子	yíbèizi	one lifetime
恐懼不安	kǒngjù bù'ān'	scared and anxious, suffering from constant fear
刻骨銘心	kègǔ míngxīn	unforgettable, to be imprinted hard in one's mind'
//當代中文/Book 4/L10-I		
何建明	Hé Jiànmíng	a male college graduate
應徵	yìngzhēng	(V) to apply for a job
配	pèi	(V) to go with, match
領帶	lǐngdài	(N) tie
花	huā	(Vs) fancy, flowery, garish
素色	sùsè	(N) plain (in color)
剩下	shèngxià	(Vpt) to remain, left (over)
龍頭	lóngtóu	(N) head, leader
起薪	qǐxīn	(N) starting salary
福利	fúlì	(N) (work) benefits
具備	jùbèi	(Vst) to have in one's qualification'
限制	xiànzhì	(N) restrictions
以上	yǐshàng	(N) above, over, more than
以下	yǐxià	(N) below, under, fewer than
相關	xiāngguān	(Vs) related, relevant
各位	gèwèi	(N) you (plural, formal)
應屆	yìngjiè	(Vs-attr) this year's, upcoming'
畢業生	bìyèshēng	(N) graduate
大一	dàyī	(N) freshman, first-year university student ( 大二 sophomore, 大三 junior, 大四 senior)
企劃部	qìhuàbù	(N) planning department ( 部 -bù, department)
營運	yíngyùn	(N) operations
知識	zhīshì	(N) knowledge
社長	shèzhǎng	(N) club president
聯合	liánhé	(Adv) jointly
音樂會	yīnyuèhuì	(N) concert
節目	jiémù	(N) program, show, event
好評	hǎopíng	(N) positive comments, praise
企劃	qìhuà	(V/N) to plan (used in business); a plan
領導	lǐngdǎo	(V) to lead
合作	hézuò	(Vi) to cooperate with, work with
似乎	sìhū	(Adv) seem
關於	guānyú	(Prep) related to, regarding
磨練	móliàn	(N/V) training, hone a skill; to train, hone, or to practice over time
優點	yōudiǎn	(N) strong point, forte
上司	shàngsī	(N) supervisor, boss
誇獎	kuājiǎng	(V) to praise, commend
週	zhōu	(M) week
內	nèi	(N) within
以	yǐ	(Prep) to use (formal)
書面	shūmiàn	(N) in writing
通知	tōngzhī	(V/N) to notify; a notification
就...而言	jiù...éryán	as far as...are concerned
新鮮人	xīnxiānrén	freshman, (here) a person, usually a college graduate, new or “fresh” to the workforce
面試官	miànshì guān	interviewing officer
自我介紹	zìwǒ jièshào	self-introduction
所學有限	suǒxué yǒuxiàn	what has been learned is only rather limited
//當代中文/Book 4/L10-II		
出國	chūguó	(V-sep) to go abroad
資金	zījīn	(N) capital, funds
廠商	chǎngshāng	(N) manufacturer
例外	lìwài	(N) exception
關	guān	(N) hurdle
接觸	jiēchù	(V) to come in contact with, to contact
青年	qīngnián	(N) young people, youth
貸款	dàikuǎn	(N) loan
開店	kāidiàn	(V-sep) to open a store
料	liào	(N) material, (here) a person not suited for…
損失	sǔnshī	(Vpt) to lose
勇氣	yǒngqì	(N) courage
員工	yuángōng	(N) employee
求職	qiúzhí	(Vi) to seek employment
目標	mùbiāo	(N) target, (here) the most ideal job
初步	chūbù	(Vs-attr) preliminary, initial
技巧	jìqiǎo	(N) tips
概念	gàiniàn	(N) concept, idea
挑	tiāo	(V) to select, pick
基本	jīběn	(Vs) basic
襯衫	chènshān	(N) button-up shirt
過程	guòchéng	(N) process
同班	tóngbān	same class
是...的料	shì...de liào	to be gifted in…
接下來	jiēxiàlái	and then, next
提不起 （勇氣）	tíbùqǐ (yǒngqì)	unable to raise...to a high level to pump up (enough courage)
養家活口	yǎngjiā huókǒu	support one's family'
來自	láizì	from 來 + literary preposition 自“ from” = 從...來
熟讀	shóudú	to keep reading something until one remembers everything
考古題	kǎogǔtí	test items from previous years ( 題 -tí, for test items)
沙盤推演	shāpán tuīyǎn	to rehearse; a dry run, a practice run
深藍色	shēn lánsè	dark blue
//當代中文/Book 4/L11-I		
種族	zhǒngzú	(N) ethnic group, race
熔爐	rónglú	(N) melting pot, smelting furnace, crucible
偏偏	piānpiān	(Adv) deliberately, insist on
肯	kěn	(Vaux) be willing to
母語	mǔyǔ	(N) mother tongue
口音	kǒuyīn	(N) accent
適應	shìyìng	(V) to adapt to, get used to
了不起	liǎobùqǐ	(Vs) terrific, amazing, really something
交流	jiāoliú	(Vi) to exchange, associate
志工	zhìgōng	(N) volunteer
縣	xiàn	(N) county
市	shì	(N) city
外籍	wàijí	(Vs-attr) foreign national
配偶	pèi'ǒu'	(N) spouse
焦慮	jiāolǜ	(Vs) to be anxious
溝通	gōutōng	(N) communication
障礙	zhàng'ài'	(N) obstacle, handicap
良好	liánghǎo	(Vs) positive
以往	yǐwǎng	(Adv) formerly, heretofore
面對	miànduì	(V) to face, confront
衝擊	chōngjí	(N) impact
大眾	dàzhòng	(N) the public, the masses
難以	nányǐ	(Adv) to find it difficult to
認同	rèntóng	(V) to identify with, accept
跨國	kuàguó	(Vs-attr) transnational
大量	dàliàng	(Adv) in large quantities
移入	yírù	(V) to immigrate ( 入 , enter, into (formal))
憂慮	yōulǜ	(Vst) to worry
降低	jiàngdī	(V) to reduce, lower
素質	sùzhí	(N) quality
歧視	qíshì	(Vst) to discriminate
子女	zǐnǚ	(N) children (from 兒子+女兒)
資產	zīchǎn	(N) asset, resource
應	yīng	(Vaux) should, ought to (formal)
平等	píngděng	(N) equality
相互	xiānghù	(Adv) mutually, each other
外人	wàirén	(N) outsider
聯絡	liánluò	(V) to contact, to connect with
小明	Xiǎomíng	Xiaoming, a nickname
家長日	jiāzhǎngrì	parents' day'
氣人	qìrén	exasperating, annoying
照說	zhào shuō	to keep on saying…
在...之餘	zài...zhīyú	to do something at a time when not doing…
本地人	běndì rén	local people
自己人	zìjǐrén	one of us, one of our own, compatriots
哪裡!哪裡!	nǎlǐ nǎlǐ	not at all, not a problem, you're welcome'
//當代中文/Book 4/L11-II		
漸漸	jiànjiàn	(Adv) gradually
曾	céng	(Adv) have been before, was once (formal)
嘗試	chángshì	(V/N) to try (something new), attempt; an attempt
結構	jiégòu	(N) structure
產生	chǎnshēng	(Vp) to take place, produce
轉變	zhuǎnbiàn	(N) change, transformation
嬰兒	yīng'ér'	(N) baby
雙親	shuāngqīn	(N) both parents
本國	běnguó	(N) our country
國籍	guójí	(N) nationality
大陸籍	Dàlùjí	(N) from Mainland China, (lit. Mainland nationality) (籍 -jí, nationality)
其	qí	(Det) his, her, its, their (formal)
比例	bǐlì	(N) ratio (percentage)
根本	gēnběn	(Vs) fundamental
可見	kějiàn	(Conj) it is obvious that, it is clearly seen that
現有	xiànyǒu	(Vs-attr) current, existing
分配	fēnpèi	(N/V) distribution, to distribute, allocate
顧慮	gùlǜ	(Vst) to be concerned about
學童	xuétóng	(N) school children
身心	shēnxīn	(N) physical and mental, mind and body
缺乏	quēfá	(Vst) to lack
課業	kèyè	(N) school work
指導	zhǐdǎo	(N/V) guidance; to give guidance to
輔導	fǔdǎo	(V) to counsel
輸	shū	(Vp) to lose out (opposite of win)
失去	shīqù	(Vp) to lose (an item), lack
然而	rán'ér'	(Conj) but, on the other hand, however
觀點	guāndiǎn	(N) perspective
加速	jiāsù	(V) to accelerate
創下	chuàngxià	(Vpt) to set (a record)
紀錄	jìlù	(N) record
明顯	míngxiǎn	(Vs) significant, obvious
下降	xiàjiàng	(Vp) to decrease
趨勢	qūshì	(N) trend
高齡化	gāolínghuà	(Vp) for a population to become aged/geriatric
世代	shìdài	(N) generation
不足	bùzú	(Vs) insufficient, not adequate
持續	chíxù	(Vaux) to continue, to keep on
正視	zhèngshì	(V) to face squarely, pay due attention to
國語	Guóyǔ	Mandarin
客語	Kèyǔ	Hakka, a Chinese (Han) dialect
最多數	zuìduōshù	the greatest majority
總人數	zǒng rénshù	total population
起跑點	qǐpǎodiǎn	starting line
新生兒	xīnshēng'ér'	a newborn baby
生產力	shēngchǎn lì	productivity
一較長短	yíjiào chángduǎn	to compete, to compare against
//當代中文/Book 4/L12-I		
王安康	Wáng Ānkāng	Wang Ankang, male
張定能	Zhāng Dìngnéng	Zhang Dingneng, male
美好	měihǎo	(Vs) wonderful, beautiful
當選	dāngxuǎn	(Vpt) to be elected to an office
無所謂	wúsuǒwèi	(Vs) I don't care; does not bother me'
敏感	mǐngǎn	(Vs) sensitive
化學	huàxué	(N) chemical, chemistry
添加物	tiānjiāwù	(N) additives
殘留	cánliú	(N) residue
修改	xiūgǎi	(V) to amend
法規	fǎguī	(N) laws and regulations, statutes
安養	ānyǎng	(N) to care for, to provide nursing care to all people
河川	héchuān	(N) river and stream
脫離	tuōlí	(Vpt) to separate oneself from, break away from
背景	bèijǐng	(N) background
領域	lǐngyù	(N) area (of study, etc.), (here) walk of life
竟然	jìngrán	(Adv) unexpectedly, surprisingly
總統	zǒngtǒng	(N) president
保障	bǎozhàng	(N/V) security (e.g., job security), to guarantee
特權	tèquán	(N) special privileges
把持	bǎchí	(V) to control
監督	jiāndū	(V) to oversee, monitor, supervise
罷免	bàmiǎn	(V) to recall, remove from office
權	quán	(N) power, authority
廉能	liánnéng	(Vs) clean and capable
富足	fùzú	(Vs) affluent, abundant
在乎	zàihū	(Vst) to care about
生命	shēngmìng	(N) life
財產	cáichǎn	(N) property, assets
義工	yìgōng	(N) volunteer
選戰	xuǎnzhàn	(N) (election) campaign
承諾	chéngnuò	(N/V) promise; to promise
帶領	dàilǐng	(V) to lead
力量	lìliàng	(N) power
擺脫	bǎituō	(V) to rid of
困境	kùnjìng	(N) dire situation, straits
房地產	fángdìchǎn	real estate
小自...大至...	xiǎozì...dàzhì...	from such trivialities to such major concerns (自 from (formal); 至 to (formal))
是否	shìfǒu	whether or not
照理說	zhào lǐ shuō	normally
政治人物	zhèngzhì rénwù	politicians
受苦	shòu kǔ	suffering
//當代中文/Book 4/L12-II		
富裕	fùyù	(Vs) rich, affluent
貪汙	tānwū	(Vp) to graft, to demand
腐敗	fǔbài	(Vs) corruption
政爭	zhèngzhēng	(N) political infighting
停滯	tíngzhì	(Vp) to stagnate, stall
上升	shàngshēng	(Vp) to rise
信心	xìnxīn	(N) confidence
遊民	yóumín	(N) street people, the homeless
外界	wàijiè	(N) the outside world
悲慘	bēicǎn	(Vs) miserable, tragic
日子	rìzi	(N) days, life
如此	rúcǐ	(Adv) such, so
巨大	jùdà	(Vs) enormous
無能	wúnéng	(Vs) incompetent
冷漠	lěngmò	(Vs) apathetic
學者	xuézhě	(N) scholars
階層	jiēcéng	(N) class hierarchy (in society)
自然	zìrán	(Adv) naturally
阻止	zǔzhǐ	(V) to prevent, block
遙遠	yáoyuǎn	(Vs) remote
無論	wúlùn	(Conj) no matter, regardless
明明	míngmíng	(Adv) clearly, obviously
骯髒	āngzāng	(Vs) dirty
顧	gù	(V) to care about
自身	zìshēn	(N) one's own'
政客	zhèngkè	(N) politico
縱容	zòngróng	(V) to condone, tolerate
使得	shǐde	(Vst) to make, to cause
工廠	gōngchǎng	(N) factory
密集	mìjí	(Vs) crowded with high density of
遭受	zāoshòu	(Vst) to suffer from, be subjected to
困苦	kùnkǔ	(Vs) distressed
老人年金	lǎorén niánjīn	annuity payment for senior citizens (provided by The National Pension Program in Taiwan)
無家可歸	wújiā kěguī	homeless, no home to go back to
以...為...	yǐ...wéi...	taking... as... (formal)
漠不關心	mòbù guānxīn	indifferent
發言權	fāyán quán	right to speak, (here) a voice (in politics, etc.)
影響力	yǐngxiǎng lì	influence
官商勾結	guānshāng gōujié	collusion between politicians and business people
貧富懸殊	pínfù xuánshū	a huge gap between the rich and the poor
息息相關	xíxí xiāngguān	inextricably related to
//當代中文/Book 5/L01-I		
言論	yánlùn	(N) speech, act of speaking
界線	jièxiàn	(N) boundaries, demarcation
臉書	Liǎnshū	(N) Facebook
則	zé	(M) measure for short, usually formal writings
留言	liúyán	(N) posted messages, comments
停止	tíngzhǐ	(Vp) to call off, to cease
決策	juécè	(N) policy
無罪	wúzuì	(Vs) not guilty
遭	zāo	(Ptc) agent marker in an adversative passive sentence
慘	cǎn	(Vs) devastated
反應	fǎnyìng	(N/V) reaction; to respond
發表	fābiǎo	(V) issue, publish (articles, news story), deliver (speeches)
司法	sīfǎ	(N) judicial
判決	pànjué	(N) judgement, sentencing (judicial)
無能	wúnéng	(Vs) to be incompetent, inept, weak
幸運	xìngyùn	(Vs) lucky, fortunate
顧名思義	gùmíng sīyì	(Id) as the name suggests/implies
接收	jiēshōu	(V) to receive
來源	láiyuán	(N) source
處罰	chǔfá	(V) to punish
包容	bāoróng	(Vst) tolerant
不論	búlùn	(Conj) regardless of whether
展現	zhǎnxiàn	(V) to reveal, show
胡作非為	húzuò fēiwéi	(Id) run amok, engage in lawless activities
一旦	yídàn	(Conj) once, as soon as
工具	gōngjù	(N) tool, instrument
洗腦	xǐnǎo	(Vi) to brainwash
權益	quányì	(N) rights and interests
盲點	mángdiǎn	(N) blind spot
立場	lìchǎng	(N) standpoint, perspective
平衡	pínghéng	(N) balance
辯護	biànhù	(Vi) to defend (legally)
無理取鬧	wúlǐ qǔnào	(Id) act up, have tantrums, talk nonsense and cause trouble
指正	zhǐzhèng	(V) to point out mistakes, correct
一來一往	yìlái yìwǎng	(Id) amidst exchanges (of opinions)
真理	zhēnlǐ	(N) the truth
越辯越明	yuèbiàn yuèmíng	(Id) the more s/t is debated, the clearer it becomes
共識	gòngshì	(N) consensus
亂象	luànxiàng	(N) chaos, madness, disorder
攻擊	gōngjí	(V) to attack
自殺	zìshā	(Vp) to commit suicide
過於	guòyú	(Adv) too, overly
事實上	shìshí shàng	(Ph) actually, in actual fact
仇恨	chóuhèn	(N) hatred, enmity, hostility
不實	bùshí	(Vs-attr) untrue, false
謠言	yáoyán	(N) rumor
霸凌	bàlíng	(N/V) bully; to bully
負責	fùzé	(Vs) to take responsibility for
誤解	wùjiě	(V) to misunderstand, misconstrue
意義	yìyì	(N) meaning, significance
因此	yīncǐ	(Adv) because of this, for this reason
否定	fǒudìng	(V) to negate
價值	jiàzhí	(N) value
封住	fēngzhù	(V) to seal, block
嘴	zuǐ	(N) mouth, opinion
混亂	hùnluàn	(Vs) tumultuous, chaotic
唯一	wéiyī	(Vs-attr) one and only, sole
//當代中文/Book 5/L01-II		
濫用	lànyòng	(V) to abuse
並非	bìngfēi	(Adv) it is not as expected
不用	búyòng	(Vaux) (there is) no need to
抓	zhuā	(V) to arrest
關	guān	(V) to lock up, imprison
名嘴	míngzuǐ	(N) TV presenters, talk show hosts or guests, talking heads
根據	gēnjù	(N) basis, foundation
隨意	suíyì	(Adv) arbitrarily, as one pleases
鄉民	xiāngmín	(N) netizens, general public
匿名	nìmíng	(Vi) to be anonymous, anonymously
正義	zhèngyì	(N) justice
惡意	èyì	(Adv/N) maliciously, viciously, ill intention
情緒	qíngxù	(N) emotions, feelings
成	chéng	(Vpt) to become
護身符	hùshēnfú	(N) amulet, charm, protective talisman
傳播	chuánbò	(V) to disseminate, spread
驚人	jīngrén	(Vs) shocking, alarming, awing
股	gǔ	(M) measure for wind, trending or power
有心	yǒuxīn	(Vs) intentional
無意	wúyì	(Vs) unintentional, inadvertent
威脅	wēixié	(N/V) threat, to threaten
諷刺	fèngcì	(V) to mock, to be sarcastic
得	dé	(Vpt) to come down with, be stricken with, get
憂鬱症	yōuyùzhèng	(N) depression
則	zé	(Adv) to express contrast with previous sentence
閉嘴	bìzuǐ	(V-sep) to shut one's mouth, keep one's mouth shut'
回應	huíyìng	(V/N) to respond, response
傷害	shānghài	(V/N) to harm, damage; damage
破壞	pòhuài	(V) to damage, cause damage to
管	guǎn	(V) to mind, watch (one's behavior, etc.)'
聰明	cōngmíng	(Vs) smart, intelligent
標題	biāotí	(N) headline
懷疑	huáiyí	(Vst) suspect
模糊	móhú	(Vs) ambiguous, vague
擅長	shàncháng	(Vst) be good at, excel at
灰色	huīsè	(N) gray
地帶	dìdài	(N) zone, area
法院	fǎyuàn	(N) court
確定	quèdìng	(V) to determine, ascertain
個人	gèrén	(N) the individual
承擔	chéngdān	(V) to take up (responsibility)
和諧	héxié	(Vs) harmonious
制定	zhìdìng	(V) to formulate, devise (laws)
嚴格	yángé	(Vs) strict, severe
約束	yuēshù	(V) to restrict, constrain
//當代中文/Book 5/L02-I		
基改	jīgǎi	(N) 基 = 基因 , 改 = 改造 (see Book 3)
農糧	nóngliáng	(N) 農 = 農作物 , crop; 糧 = 糧食 ,food
廣播節目	guǎngbò jiémù	(Ph) broadcast program
主持人	zhǔchírén	(N) host, MC
聽眾	tīngzhòng	(N) listening audience, listeners
播	bò	(V) to broadcast
蟲子	chóngzi	(N) insect, bug
隔壁	gébì	(N) next door
回答	huídá	(V) to answer
死	sǐ	(Vp) to die
話題	huàtí	(N) topic
危害	wéihài	(V) to harm, be detrimental to, endanger
贊成	zànchéng	(Vst) to approve, in favor
各式各樣	gèshì gèyàng	(Id) all types of, various kinds of
只不過	zhǐbúguò	(Ph) only, no more than
種子	zhǒngzǐ	(N) seed
比如說	bǐrú shuō	(Ph) for example
維他命	wéitāmìng	(N) vitamin
蔬果	shūguǒ	(N) fruits and vegetables
抗癌	kàng'ái'	(Vs) anti-cancerous
過敏	guòmǐn	(Vs) allergic
花生	huāshēng	(N) peanut
科學家	kēxuéjiā	(N) scientist
豐富	fēngfù	(Vs) rich (abundant in something)
享用	xiǎngyòng	(V) to enjoy the use of, enjoy (a meal)
達到	dádào	(Vpt) to reach, obtain
預防	yùfáng	(Vst) to prevent, guard against
疾病	jíbìng	(N) illness, sickness
效果	xiàoguǒ	(N) effect, results
好幾（種）	hǎojǐ (zhǒng)	(Ph) a number of, quite a few kinds of
警告	jǐnggào	(V/N) to warn, warning
突破	túpò	(Vpt) to make a breakthrough, top, break (a record, number)
糧食	liángshí	(N) food, foodstuff
早晚	zǎowǎn	(Adv) sooner or later
不僅	bùjǐn	(Adv) not only
農作物	nóngzuòwù	(N) crop, produce
抵抗力	dǐkàng lì	(N) resistance, immunity
蟲害	chónghài	(N) damage by pests
產量	chǎnliàng	(N) output, yield, production
飢荒	jīhuāng	(N) famine
含有	hányǒu	(Vst) to contain, have
大豆	dàdòu	(N) soybean, soya
玉米	yùmǐ	(N) corn
密不可分	mìbù kěfēn	(Id) inseparable, integrated with
生產	shēngchǎn	(V) to produce, manufacture
缺少	quēshǎo	(Vst) to be in shortage of
依賴	yīlài	(Vst) to rely on, depend on
進口	jìnkǒu	(V) to import
危機	wéijī	(N) crisis
生物科技	shēngwù kējì	(Ph) bio-tech
機構	jīgòu	(N) organization, depts. of gov't'
證據	zhèngjù	(N) proof, evidence
證明	zhèngmíng	(V/N) to prove; proof
人體	réntǐ	(N) the human body
結論	jiélùn	(N) conclusion
生長	shēngzhǎng	(Vi) to grow
除草劑	chúcǎojì	(N) weed killer, herbicide
物質	wùzhí	(N) matter, substance
怪物	guàiwù	(N) monster
原料	yuánliào	(N) raw materials
包裝	bāozhuāng	(N) packaging
標示	biāoshì	(V/N) to label; mark
一切	yíqiè	(Det) all
//當代中文/Book 5/L02-II		
昆蟲	kūnchóng	(N) insect
不孕	búyùn	(Vs) to be infertile, barren
罹患	líhuàn	(Vpt) to come down with, be stricken with, suffer from
癌症	áizhèng	(N) cancer
蘋果	píngguǒ	(N) apple
鮭魚	guīyú	(N) salmon
不知不覺	bùzhī bùjué	(Id) without even realizing it, before you even know it, without one even noticing
辨別	biànbié	(V) to distinguish, tell apart
安心	ānxīn	(Vs) to have peace of mind, set one's mind at rest'
雜誌	zázhì	(N) magazine, journal
編輯	biānjí	(V) to edit
後果	hòuguǒ	(N) consequence, result
雜草	zácǎo	(N) weed
某	mǒu	(Det) certain, some
專利	zhuānlì	(N) patent
農民	nóngmín	(N) farmer
收購	shōugòu	(V) acquire, buy out
居高不下	jūgāo búxià	(Id) remain high, won't come down'
絕對	juéduì	(Adv) absolutely, in no way
符合	fúhé	(Vst) to meet with, conform with
非	fēi	(Vst) not (classical Chinese)
事實	shìshí	(N) fact, truth
種植	zhòngzhí	(V) to plant, cultivate
總用量	zǒng yòngliàng	(Ph) total dosage
公斤	gōngjīn	(N) kilogram
即便	jíbiàn	(Conj) even if, despite
兼	jiān	(Adv) concurrently, simultaneously
欺騙	qīpiàn	(V) to deceive, scam, cheat
國人	guórén	(N) (our) fellow countrymen
立法	lìfǎ	(V-sep) to make a law
以	yǐ	(Adv) so as to, such that
維護	wéihù	(V) to safeguard, protect
神奇	shénqí	(Vs) magical, miraculous
手段	shǒuduàn	(N) means, measure
付出	fùchū	(V) to pay (a heavy price for)
代價	dàijià	(N) (to pay a heavy) price
掌握	zhǎngwò	(V) to hold, grasp, control
//當代中文/Book 5/L03-I		
風氣	fēngqì	(N) ethos, mood (said of society, a nation etc.)
開放	kāifàng	(N) (nominalized from its verb from) to open up to the outside world; liberal, non-conservative
意外	yìwài	(N) accident
存在	cúnzài	(Vs) to exist
內在	nèizài	(N) internal quality
特質	tèzhí	(N) characteristic, quality
勝	shèng	(Vst) be superior to, to win (classical Chinese)
醜	chǒu	(Vs) ugly
顏值	yánzhí	(N) “face value” (play on words)
他人	tārén	(N) other people, others
不盡然	bújìnrán	(Vs) not necessarily so
要求	yāoqiú	(V) to request, demand
整出	zhěngchū	(V) to produce (through plastic surgery)
鼻子	bízi	(N) nose
皮膚	pífū	(N) skin
細	xì	(Vs) thin, slender
腰	yāo	(N) waist, small of the back
豐胸	fēngxiōng	(N) large breasts
高挺	gāotǐng	(Vs) to be high-bridged (said of noses)
水汪汪	shuǐwāngwāng	(Vs) to be “doe-eyed”
參賽	cānsài	(Vi) to take part in a competition
眼光	yǎnguāng	(N) judgment, how others look at you
矛盾	máodùn	(Vs) contradictory
外貌	wàimào	(N) looks, appearance, exterior
美滿	měimǎn	(Vs) happy, fulfilled (said of families, lives, marriages, etc.)
職涯	zhíyá	(N) career
以貌取人	yǐmào qǔrén	(Id) judge a book by its cover; judge by appearance (said of people)
不計一切	bújì yíqiè	(Id) do whatever it takes
英俊	yīngjùn	(Vs) handsome
獲得	huòdé	(Vpt) to obtain, attain
青睞	qīnglài	(N) special attention and favor
對象	duìxiàng	(N) significant other, boyfriend/girlfriend, object of love
智力	zhìlì	(N) intelligence
同樣	tóngyàng	(Vs) in the same way; similar
團隊	tuánduì	(N) team
金錢	jīnqián	(N) money
投資	tóuzī	(V/N) to invest; investment
行為	xíngwéi	(N) behavior
儘管	jǐnguǎn	(Conj) even though, although
日漸	rìjiàn	(Adv) with each day, with each passing day, gradually
失敗	shībài	(Vp) to fail
胸部	xiōngbù	(N) breast, chest
大小不一	dàxiǎo bùyī	(Id) in different sizes, of various sizes
變形	biànxíng	(Vp) to be deformed
失血	shīxiě	(Vp-sep) to lose blood
過	guò	(Adv) excessively
飽受	bǎoshòu	(Vpt) to suffer greatly from
後遺症	hòuyízhèng	(N) after-effects, sequela
副作用	fùzuòyòng	(N) side-effects
多麼	duōme	(Adv) how
冒險	màoxiǎn	(V-sep) to risk, take risk, adventure
如今	rújīn	(Adv) nowadays, today
捷徑	jiéjìng	(N) shortcut
進而	jìn'ér'	(Adv) furthermore
謹慎	jǐnshèn	(Vs) careful, cautious
看待	kàndài	(V) to regard
//當代中文/Book 5/L03-II		
吹	chuī	(V) to blow (used in the text to mean a trend h as been “circulating” or “stirring”)
旅遊	lǚyóu	(N) tour, trip
極具	jíjù	(Vst) to strongly possess (classical Chinese)
潛力	qiánlì	(N) potential
理由	lǐyóu	(N) reason
天性	tiānxìng	(N) nature, instinct
列入	lièrù	(V) to include, take into
考量	kǎoliáng	(N) consideration
公關	gōngguān	(N) public relations
時尚	shíshàng	(N) fashion, trend
產業	chǎnyè	(N) industry
眼皮	yǎnpí	(N) eyelid
精神奕奕	jīngshén yìyì	(Id) full of vigor/life/vitality
違反	wéifǎn	(V) to violate, go against
假	jiǎ	(Vs) false, fake, bogus
造假	zàojiǎ	(Vi) to cheat, deceive
標籤	biāoqiān	(N) label
優勢	yōushì	(N) advantage
理解	lǐjiě	(Vst) to understand
生來	shēnglái	(Ph) from birth (= 出生以來 )
差異	chāyì	(N) difference
天生	tiānshēng	(Adv) inherently
後天	hòutiān	(N) in later stages of development
長相	zhǎngxiàng	(N) appearance, looks
平平	píngpíng	(Vs) plain, average, mediocre
醫學	yīxué	(N) medical science
縮小	suōxiǎo	(V) to shrink, shorten
差距	chājù	(N) gap, distance between
無疑	wúyí	(Adv) undoubtedly
器材	qìcái	(N) equipment
藥品	yàopǐn	(N) drug, medicine
大幅	dàfú	(Adv) substantially, sharply
事先	shìxiān	(Adv) beforehand, in advance
評估	pínggū	(V) to evaluate, assess
患者	huànzhě	(N) patient
動機	dòngjī	(N) motivation
狀態	zhuàngtài	(N) state, situation
執行	zhíxíng	(V) to carry out, execute
身體髮膚受之父母	shēntǐ fǎfū, shòuzhī fùmǔ	(Id) your body, from your hair to your skin, is a gift from your parents (suggests that you have a responsibility to cherish and care for it)
剪	jiǎn	(V) to cut (with scissors)
理會	lǐhuì	(V) to pay attention to
有何不可	yǒuhé bùkě	(Id) What's wrong with that? and why not? what's the harm in that?'
//當代中文/Book 5/L04-I		
刪減	shānjiǎn	(V) to cut, cut back on (as in funds, personnel, etc.)
鬥牛	dòuniú	(N) bullfighting
街頭	jiētóu	(N) the streets (used in phrases like “take to the streets”)
舉	jǔ	(V) to raise, hold up
示威	shìwēi	(Vi) to demonstrate, rally
主張	zhǔzhāng	(V/N) to advocate a view or a standard
保存	bǎocún	(V) to preserve
廢止	fèizhǐ	(V) to abolish
引發	yǐnfā	(Vst) to set off, trigger
正反	zhèngfǎn	(N) protesters and supporters, pros and cons
兩方	liǎngfāng	(N) both parties, the two sides
激烈	jīliè	(Vs) to be intense, fierce
具有	jùyǒu	(Vst) to have, possess
祭品	jìpǐn	(N) offering to god(s), sacrificial items
全民	quánmín	(N) all the people
座	zuò	(M) measure for large objects like mountains, castles, gigantic temples on hilltops
鬥牛場	dòuniú chǎng	(N) bullfighting ring
馬德里	Mǎdélǐ	(N) Madrid
至今	zhìjīn	(Adv) to this day, heretofore
鬥牛士	dòuniú shì	(N) bullfighter
華麗	huálì	(Vs) magnificent, resplendent
服飾	fúshì	(N) clothing and accessories, apparel, costume
一面	yímiàn	(Adv) on the one hand, on the other; (do A), while (doing B)
披風	pīfēng	(N) cape
激怒	jīnù	(V) to infuriate, excite
公牛	gōngniú	(N) bull
優雅	yōuyǎ	(Vs) graceful, elegant
姿勢	zīshì	(N) posture, position, poses
結合	jiéhé	(N/V) union, blend; to combine, unite, blend
過人	guòrén	(Vs) unsurpassable
熟練	shóuliàn	(Vs) adept, skillful, proficient
崇拜	chóngbài	(Vst) to worship, adore
旺季	wàngjì	(N) peak season
遊客	yóukè	(N) visitor, tourist
前往	qiánwǎng	(V) to go to, head to
觀賞	guānshǎng	(V) to view, enjoy the view of
奔牛節	Bēnniújié	(N) The Running of the Bulls (in Pamplona)
重頭戲	zhòngtóuxì	(N) the main event
狂奔	kuángbēn	(Vi) to run madly, run like crazy
歐元	Ōuyuán	(N) Euro (currency)
必要	bìyào	(N) need
獨特	dútè	(Vs) unique
魅力	mèilì	(N) charisma
戲劇	xìjù	(N) drama, play
無數	wúshù	(Vs-attr) countless
靈感	línggǎn	(N) inspiration
諾貝爾	Nuòbèi'ěr'	(N) Nobel
得主	dézhǔ	(N) winner
作家	zuòjiā	(N) writer, author
海明威	Hǎimíngwēi	(N) Ernest Hemmingway
觀看	guānkàn	(V) to watch
小說	xiǎoshuō	(N) novel
舉世聞名	jǔshì wénmíng	(Id) world-famous
推廣	tuīguǎng	(V) to promote
遺產	yíchǎn	(N) heritage
由來已久	yóulái yǐjiǔ	(Id) age-old
//當代中文/Book 5/L04-II		
過時	guòshí	(Vs) passé, obsolete
不利	búlì	(Vs) disadvantageous to, detrimental to
刺	cì	(V) to stab, gore
觀眾	guānzhòng	(N) viewing audience
轉播	zhuǎnbò	(V/N) to rebroadcast, transmission, relay
幕	mù	(M) measure for scenes
血淋淋	xiělínlín	(Vs) bloody, gory
畫面	huàmiàn	(N) scene, graphics
頭	tóu	(M) measure for cattle (i.e., a head of cattle)
死亡	sǐwáng	(Vp) to die
折磨	zhémó	(N/V) torment; to torture
賠上	péishàng	(V) to pay as compensation
俗話	súhuà	(N) saying
道理	dàolǐ	(N) principle, truth, reason
自私	zìsī	(Vs) selfish
虐待	nüèdài	(V) to abuse, maltreat
開設	kāishè	(V) to start, open up (a course)
課程	kèchéng	(N) course
教導	jiàodǎo	(V/N) to teach; instruction
享有	xiǎngyǒu	(Vst) to enjoy (a privilege)
不人道	bùréndào	(Vs) inhumane
無辜	wúgū	(Vs) innocent
寶貴	bǎoguì	(Vs) precious
提升	tíshēng	(V) to elevate, raise (as in awareness)
社群	shèqún	(N) social group, community (as in social network, social media)
殘忍	cánrěn	(Vs) to be cruel
刊登	kāndēng	(V) (for a media) to carry (a photo, article), publish
高喊	gāohǎn	(V) to shout, scream, cry out
顯示	xiǎnshì	(V) to show, reveal
高達	gāodá	(Vst) as high as
僅	jǐn	(Adv) only
無須	wúxū	(Vaux) need not
巴塞隆納	Bāsàilóngnà	(N) Barcelona
宣布	xuānbù	(V) to announce
娛樂	yúlè	(N) recreation, amusement, entertainment
入場	rùchǎng	(Vi) to enter (a venue)
澈底	chèdǐ	(Adv) completely, thoroughly
//當代中文/Book 5/L05-I		
代理孕母	dàilǐ yùnmǔ	(Ph) surrogate mother
案例	ànlì	(N) case, instance
名	míng	(M) measure for people (formal)
同志	tóngzhì	(N) homosexual, gay
心願	xīnyuàn	(N) wish, heart's desire'
自願	zìyuàn	(Vaux) to volunteer, out of one's own wish'
委託	wěituō	(V/N) to commission, to charge with; commission
龍鳳胎	lóngfèng tāi	(Ph) twins (one boy and one girl)
遺棄	yíqì	(V) to abandon, desert
缺陷	quēxiàn	(N) defect, imperfection
任	rèn	(M) measure for terms (e.g., first term as president)
丈夫	zhàngfū	(N) husband
懷孕	huáiyùn	(Vp-sep) to be pregnant
毛遂自薦	máosuì zìjiàn	(Id) volunteer one's services, recommend oneself'
日新月異	rìxīn yuèyì	(Id) to advance with each passing day
倫理	lúnlǐ	(N) ethics
整合	zhěnghé	(V) to integrate
合法化	héfǎhuà	(Vp) to legalize
需求	xūqiú	(N) demand, need, requirements
一線希望	yíxiàn xīwàng	(Id) a ray of hope, minimal possibility
惡夢	è'mèng'	(N) nightmare
看似	kànsì	(Vst) seemingly, look like, seem
費盡	fèijìn	(V) to take great pains to, exert great effort to
千辛萬苦	qiānxīn wànkǔ	(Id) untold hardships, innumerable trials and tribulations
因素	yīnsù	(N) factor, element
皆	jiē	(Adv) all (same as 都 but formal)
承受	chéngshòu	(V) to bear, withstand, put up with
不得已	bùdéyǐ	(Vs) to have no choice but to, to be forced to, have to
代孕	dàiyùn	(Vi) to surrogate, to perform surrogacy
婚外情	hūnwàiqíng	(N) extramarital affair
破碎	pòsuì	(Vs) to break, shatter
悲劇	bēijù	(N) tragedy
雙方	shuāngfāng	(N) both parties
渴望	kěwàng	(N/Vst) longing, yearning; to long for, yearn for
供需	gōngxū	(N) supply and demand
利人利己	lìrén lìjǐ	(Id) benefit both oneself and others
雙贏	shuāngyíng	(Vi) win-win
反觀	fǎnguān	(V) looking back on, contrasting this with, when we reflect on
連續	liánxù	(Adv) continuously, in a row, successively
排名	páimíng	(Vst) to rank
倒數	dàoshǔ	(Vs-attr) counting backward, from the end, from the bottom of the list (in English, 倒數第二名 can be translated “second worst/lowest/least”)
始終	shǐzhōng	(Adv) all the while, all along, invariably
忽視	hūshì	(V) to ignore, neglect, overlook
夫妻	fūqī	(N) husband and wife, married couple
協助	xiézhù	(V) to assist
長輩	zhǎngbèi	(N) elder, one's superior'
忍受	rěnshòu	(Vst) to endure, suffer
如願	rúyuàn	(Vs-sep) as one hopes, as one wishes
自主權	zìzhǔquán	(N) right to make one's own decisions, autonomy'
//當代中文/Book 5/L05-II		
固然	gùrán	(Adv) granted, certainly, while it is definitely true that
交易	jiāoyì	(Vi) to trade, transact, carry out a transaction
屬	shǔ	(Vst) to belong to, be part of (a category)
族群	zúqún	(N) group of people (e.g., ethnic group, disadvantaged group)
等於	děngyú	(Vst) tantamount to, equal to
階級	jiējí	(N) class (in society)
間接	jiànjiē	(Adv) indirectly
錯誤	cuòwù	(N) mistake
性別	xìngbié	(N) sex, gender
抽菸	chōuyān	(Ph) to smoke a cigarette
胎兒	tāi'ér'	(N) fetus
不良	bùliáng	(Vs-attr) harmful, bad
分離	fēnlí	(Vi) to be separated from
契約	qìyuē	(N) contract, agreement
仲介	zhòngjiè	(N) intermediary, agent, middleman
角色	jiǎosè	(N) role
涉及	shèjí	(Vst) to involve, relate to
規範	guīfàn	(V/N) to regulate, standardize; standard
黑白不分	hēibái bùfēn	(Id) cannot tell truth from non-truth
是非不明	shìfēi bùmíng	(Id) cannot tell truth from non-truth
紛紛	fēnfēn	(Adv) one after another, in succession
精子	jīngzǐ	(N) sperm
搞定	gǎodìng	(V) to have it resolved
獨一無二	dúyī wú'èr'	(Id) unique, one of a kind
總之	zǒngzhī	(Adv) to sum it up, in short, in conclusion
//當代中文/Book 5/L06-I		
死刑	sǐxíng	(N)capital punishment, the death penalty
存廢	cúnfèi	(N) preservation or abolishment, to preserve or to abolish (contracted word from 保存 + 廢除)
爭議	zhēngyì	(N) controversy
僵局	jiāngjú	(N) stalemate, deadlock, impasse
各自	gèzì	(Adv) each, respectively
嚇阻	hèzǔ	(V) to deter (through intimidation)
隔離	gélí	(V) to isolate, separate, quarantine
罪犯	zuìfàn	(N) criminal
隨機	suíjī	(Adv) randomly
殺害	shāhài	(V) to murder, kill
黑心	hēixīn	(Vs-attr) darkened heart; evil mind (黑心食品 = unsafe food, i.e., made by profit-oriented people/companies with no conscience)
案件	ànjiàn	(N) (legal) case
法官	fǎguān	(N) judge
判	pàn	(V) to judge, rule, give sentencing
有期徒刑	yǒuqí túxíng	(Ph) prison term (sentencing with a fixed prison term)
無期徒刑	wúqí túxíng	(Ph) life sentence (i.e., no chance of parole)
死者	sǐzhě	(N) the dead person, the murder victim
交代	jiāodài	(N) a satisfactory answer, briefing, accountability
彌補	míbǔ	(V) to make up for, compensate for
家屬	jiāshǔ	(N) family, family members
或者	huòzhě	(Conj) or
犯人	fànrén	(N) criminal, prisoner
出獄	chūyù	(Vi) to be released from prison (監獄 , jiānyù , prison)
把	bǎ	(M) measure for “graspable” objects like rulers , chairs, salt etc
尺	chǐ	(N) ruler
現行	xiànxíng	(Vs-attr) existing, current
假釋	jiǎshì	(Vi) parole
永久	yǒngjiǔ	(Adv) forever, permanently
害怕	hàipà	(Vs) to be afraid of, to fear
報復	bàofù	(V/N) to retaliate, get revenge; vengeance
納稅	nàshuì	(V-sep) to pay taxes
懲罰	chéngfá	(N/V) punishment; to punish
犯罪	fànzuì	(V-sep) to commit a crime
罰單	fádān	(N) ticket (for a fine)
闖紅燈	chuǎng hóngdēng	(Ph) run a red light ( 闖 ,to rush, break through; 紅燈 , red light)
開	kāi	(V) to write (a ticket)
同理	tónglǐ	(Adv) by the same token, similarly
換句話說	huànjùhuà shuō	(Ph) in other words, to put it another way
維持	wéichí	(V) to keep, maintain
相較於	xiāngjiào yú	(Ph) in comparison to, compared to (classical Chinese)
人權	rénquán	(N) human rights
廢除	fèichú	(V) to abolish
被害人	bèihàirén	(N) victim
孤兒	gū'ér'	(N) orphan
不然	bùrán	(Conj) otherwise
毀	huǐ	(V) to destroy
氣憤	qìfèn	(Vs) indignant, angry
恨	hèn	(Vst) to hate
報仇	bàochóu	(V-sep) to get revenge, get vengeance
便宜	piányí	(Vst) to let somebody off easy
置身事外	zhìshēn shìwài	(Id) to remain aloof, sit on the sidelines, not be involved
放下	fàngxià	(V) let it go, let it be, “forgive”
凶手	xiōngshǒu	(N) murderer, killer
感同身受	gǎntóng shēnshòu	(Id) to empathize, feel like own experience
生前	shēngqián	(N) during one's life, before one's death'
恐懼	kǒngjù	(N) fear
心痛	xīntòng	(Ph) the pain in one's heart, heartbreak, heartache'
天平	tiānpíng	(N) balance, scales
衡量	héngliáng	(V) to weigh, evaluate
坦白	tǎnbái	(Vs) honesty, honest ( 坦白說 = to be honest/frank/candid)
撫慰	fǔwèi	(V) to console, comfort
剛剛好	gānggāng hǎo	(Ph) just right, just enough, just the right amount, time, color, etc. (meaning here: justice done)
//當代中文/Book 5/L06-II		
無濟於事	wújì yúshì	(Id) to not help the situation; does not do anybody good, of no use
致力	zhìlì	(Adv) with all might and mind
推動	tuīdòng	(V) to promote, push
漫漫長路	mànmàn chánglù	(Id) a long road, there is still a long way to go
刑罰	xíngfá	(N) punishment, penalty
顯得	xiǎnde	(Vaux) to appear, seem, come off as
費	fèi	(V) to exert (lit. pay out)
心力	xīnlì	(N) effort (physical and mental)
冤枉	yuānwǎng	(V) to be wronged, treated unjustly
槍決	qiāngjué	(N/V) execution by shooting; to execute by shooting
犯案	fàn'àn'	(Vp-sep) to be implicated in a crime
充足	chōngzú	(Vs) ample, sufficient, adequate
保證	bǎozhèng	(V/N) to guarantee; guarantee
誤判	wùpàn	(V/N) to err in judicial judgement; erroneous judgement, miscarriage of justice
失誤	shīwù	(N) mistake, error
無價	wújià	(Vs) priceless
賠償	péicháng	(N/V) compensation, reparation; to compensate, make reparations
善良	shànliáng	(Vs) good and kind
一面	yímiàn	(Ph) side (i.e., a good side)
可貴	kěguì	(Vs) valuable, priceless
同情	tóngqíng	(Vst/N) to sympathize; sympathy
換不回	huànbùhuí	(Ph) cannot get it back
和解	héjiě	(Vi) to reconcile, make up
認錯	rèncuò	(V-sep) to admit one's error'
重新	chóngxīn	(Adv) anew, afresh
大愛	dà'ài'	(N) great love, love at the highest level
感受	gǎnshòu	(N) feelings
只是	zhǐshì	(Adv) but at the same time, we must realize that
一命還一命	yímìng huán yímìng	(Id) a life for a life, an eye for an eye
好受	hǎoshòu	(Vs) to feel better
也就是說	yějiùshìshuō	(Ph) that is to say, that is, i.e.,
歐盟	Ōuméng	(N) the EU, European Union
潮流	cháoliú	(N) trend
意識到	yìshìdào	(Vpt) to be conscious of, to be aware of
唯有	wéiyǒu	(Adv) only by
身旁	shēnpáng	(N) next to, around you
打造	dǎzào	(V) to create, implement
根本	gēnběn	(Adv) completely, fundamentally, thoroughly
//當代中文/Book 5/L07-I		
傷腦筋	shāng nǎojīn	(Id) to cause a headache, a pain in the neck, to be knotty/troublesome (said of issues or problems)
受益	shòuyì	(Vp) to be benefited, to benefit (from)
財富	cáifù	(N) wealth
思考	sīkǎo	(V) to ponder
清晨	qīngchén	(N) early morning
同齡	tónglíng	(Vs) to be of the same age
遇上	yùshàng	(Vpt) to encounter, come across
白工	báigōng	(N) work done in vain, wasted work
沖走	chōngzǒu	(V) to be washed away
（一）大半	(yí) dàbàn	(Ph) a huge portion of, more than half
慘重	cǎnzhòng	(Vs) heavy (said of losses)
值錢	zhíqián	(Vs) valuable
村	cūn	(N) village
可憐	kělián	(Vs) pitiful, pitiable, poor
相依為命	xiāngyī wéimìng	(Id) to depend on each other (for survival)
一身病痛	yìshēn bìngtòng	(Id) illness and pain all over the body
懂事	dǒngshì	(Vs) sensible, to have a good head on one's shoulders'
主動	zhǔdòng	(Adv) take the initiative, take it upon oneself to
援助	yuánzhù	(V/N) to assist; assistance, aid
口袋	kǒudài	(N) pocket
吃力	chīlì	(Vs) to entail strenuous effort, be a strain
家產	jiāchǎn	(N) family property
一無所有	yìwú suǒyǒu	(Id) have nothing at all, not own a thing in the world, penniless
對於	duìyú	(Prep) as to, with regard to, to
累積	lěijī	(V) to accumulate
貧戶	pínhù	(N) households below poverty line
袖手旁觀	xiùshǒu pángguān	(Id) stand by and watch, sit there twiddling one's thumbs, not lift a finger'
調整	tiáozhěng	(V/N) to adjust; adjustment
創造	chuàngzào	(V) to create
津貼	jīntiē	(N) allowance (as in travel allowance)
等同	děngtóng	(Vst) tantamount to, equivalent to
補貼	bǔtiē	(V/N) to subsidize; subsidy
分子	fènzǐ	(N) member (of an organization)
舉例	jǔlì	(V-sep) to give an example
工資	gōngzī	(N) pay, salary
完善	wánshàn	(Vs) fully devised, perfect
出手	chūshǒu	(Vi) to spend, hand out, pay out
大方	dàfāng	(Vs) generous, magnanimous
在於	zàiyú	(Vst) to lie in (the fact that), consist in
進行	jìnxíng	(V) to carry out, conduct, undertake
共享	gòngxiǎng	(V) to share, enjoy
倘若	tǎngruò	(Conj) if, in the event that, supposing
不服	bùfú	(Vs) to refuse to accept, unconvinced
稅收	shuìshōu	(N) tax revenue
生存	shēngcún	(Vi/N) to survive, exist; survival
提心吊膽	tíxīn diàodǎn	(Id) on tenterhooks, nervous
警力	jǐnglì	(N) police force
治安	zhì'ān'	(N) public security
//當代中文/Book 5/L07-II		
哈佛大學	Hāfó Dàxué	(N) Harvard University
課堂	kètáng	(N) classroom
心臟	xīnzàng	(N) heart (organ)
肺臟	fèizàng	(N) lung
腎臟	shènzàng	(N) kidney
急迫	jípò	(Vs) urgent, pressing
器官	qìguān	(N) organ
移植	yízhí	(V) to transplant
捐贈	juānzèng	(V) to donate
突然	túrán	(Adv) suddenly
全身	quánshēn	(N) entire body
麻醉	mázuì	(V) to anesthetize (全身麻醉 general anesthesia)
抽	chōu	(V) to levy (a tax)
迫切	pòqiè	(Vs) urgent
眾人	zhòngrén	(N) people in general, the multitude
奪取	duóqǔ	(V) to seize, take by force
堂	táng	(M) measure for classes (in terms of minutes; not for courses, classrooms, or students that make up a class)
奮鬥	fèndòu	(Vi) to struggle, strive
犧牲	xīshēng	(V) to sacrifice
埋	mái	(V) to bury
繳稅單	jiǎoshuìdān	(N) tax form
無所事事	wúsuǒ shìshì	(Id) have nothing to do, to lay idle (here, unemployed)
短暫	duǎnzhàn	(Vs) transient, short, brief
拼	pīn	(Vs) to work hard
醒	xǐng	(Vp) to wake up, awaken
苦笑	kǔxiào	(Vi) to smile bitterly/wryly, to force a smile
歪理	wāilǐ	(N) preposterous argument (i.e., that's dumb! What idiot thought that up?!) '
米蟲	mǐchóng	(N) sponge, parasite (lit. a rice bug)
仍舊	réngjiù	(Adv) still
劫富濟貧	jiéfù jìpín	(Id) steal from the rich and give to the poor (spirit of Robin Hood)
強制	qiǎngzhì	(Adv) by force into, coerced into
奪走	duózǒu	(V) to take away, snatch
被迫	bèipò	(Vs) to be forced, compelled
捐款	juānkuǎn	(V-sep) to donate money
眼紅	yǎnhóng	(Vs) to covet, envious
分享	fēnxiǎng	(V) to share
成果	chéngguǒ	(N) outcome, result
不勞而獲	bùláo érhuò	(Id) to reap where one has not sown, get something for nothing
依靠	yīkào	(V) to rely on, depend on
拉	lā	(V) to pull
貧窮	pínqióng	(N) poverty
強盜	qiángdào	(N) robber
打擊	dǎjí	(V) to strike a blow to
創富	chuàngfù	(Vi) to create wealth
介入	jièrù	(V) to intervene, get involved in
//當代中文/Book 5/L08-I		
左右為難	zuǒyòu wéinán	(Id) in a dilemma, be in a bind, in a predicament, in a fix
難民	nànmín	(N) refugees
男童	nántóng	(N) boy, male child
溺死	nìsǐ	(Vp) to drown (to death), die from drowning
震驚	zhènjīng	(Vpt) to shock, stun, startle
接連	jiēlián	(Adv) in succession, in a row
事件	shìjiàn	(N) incident, episode
不滿	bùmǎn	(Vs) discontent, unhappy with
分擔	fēndān	(V) to share a burden, share responsibility
化	huà	(V) to turn into, change into, convert into, transform into
轉機	zhuǎnjī	(N) (life-saving) opportunity
海面	hǎimiàn	(N) the surface of the ocean/sea
難以數計	nányǐ shùjì	(Id) countless (lit. hard to calculate)
屍體	shītǐ	(N) corpse, body
怵目驚心	chùmù jīngxīn	(Id) shocked to witness
冒	mào	(V) to risk
聯合國	Liánhéguó	(N) United Nations, UN
止	zhǐ	(Ptc) until (classical Chinese)
庇護	bìhù	(N) asylum
人數	rénshù	(N) number of people
面臨	miànlín	(V) to face, confront
團結	tuánjié	(Vi) to unite, form solidarity with
召開	zhàokāi	(V) to convene, hold (a meeting)
高峰會	gāofēng huì	(N) Summit (meeting)
領袖	lǐngxiù	(N) leader, head of a state
消除	xiāochú	(V) to eliminate
仇外	chóuwài	(Vs) anti-foreign
前...	qián...	(N) former-, ex-
歐巴馬	Ōubāmǎ	(N) Barack Obama (former US president)
會議	huìyì	(N) conference, meeting
主義	zhǔyì	(N) “-ism” (as in terrorism, communism)
受害者	shòuhàizhě	(N) victim
向來	xiànglái	(Adv) always, all along
單一	dānyī	(Vs-attr) one, single (any one country's responsibility)'
共同	gòngtóng	(Adv) together, jointly
排外	páiwài	(Vi) anti-foreign, xenophobic
融入	róngrù	(V) to integrate, blend in
收容	shōuróng	(V) to offer refuge to
或許	huòxǔ	(Adv) perhaps, probably
勞動力	láodònglì	(N) manpower
轉化	zhuǎnhuà	(Vi) to change into, transform into
里約	Lǐyuē	(N) Rio, Brasil
奧運	Àoyùn	(N) Olympics
首度	shǒudù	(Adv) first time
代表隊	dàibiǎoduì	(N) representative team, team representing
逃離	táolí	(V) to escape from, flee from
戰火	zhànhuǒ	(N) fires of war
殘障	cánzhàng	(N) physical disability
忘掉	wàngdiào	(Vpt) to forget
英雄	yīngxióng	(N) hero
身分	shēnfèn	(N) identification
索馬利亞	Suǒmǎlìyǎ	(N) Somalia
之後	zhīhòu	(N) subsequent to that
參選	cānxuǎn	(V) to run in an election
膚色	fūsè	(N) skin color
早日	zǎorì	(Adv) soon
扶持	fúchí	(V) to support, help, aid, assist
//當代中文/Book 5/L08-II		
優先	yōuxiān	(Vs) to be given priority
無力	wúlì	(Vst) incapable of, powerless to
安置	ānzhì	(V) to make proper living arrangements for
支出	zhīchū	(N/V) expenditure; to expend
導致	dǎozhì	(V) to cause, result in, lead to
賦稅	fùshuì	(N) taxes
居民	jūmín	(N) resident
對立	duìlì	(Vs) to oppose, be in opposition to, be antagonistic
罷了	bàle	(Ptc) merely, that's it, that is all'
德國	Déguó	(N) Germany
每況愈下	měikuàng yùxià	(Id) to deteriorate, go downhill, go from bad to worse
拖垮	tuōkuǎ	(V) to pull down with, drag down
忽略	hūlüè	(V) to ignore, overlook
一一	yīyī	(Adv) one by one, separately
過濾	guòlǜ	(V) to filter
有機可乘	yǒujī kěchéng	(Id) take advantage of a situation
接二連三	jiē'èr liánsān'	(Id) one after another, in rapid succession
衝突	chōngtú	(Vs) to conflict
升高	shēnggāo	(Vp) to increase, rise
在在	zàizài	(Adv) in all aspects (classical Chinese)
設置	shèzhì	(V) to establish, set up
難民營	nànmínyíng	(N) refugee camp
關閉	guānbì	(V) to close down
邊界	biānjiè	(N) border
通往	tōngwǎng	(V) to go to, lead to
交託	jiāotuō	(V) to entrust (one's safety, life, etc.) to'
人口	rénkǒu	(N) human
販子	fànzi	(N) trafficker
助長	zhùzhǎng	(V) to foster, encourage (negatively)
支付	zhīfù	(V) to make a payment to
總理	zǒnglǐ	(N) chancellor, prime minister, premier
梅克爾	Méikè'ěr'	(N) Merkel (German chancellor)
承認	chéngrèn	(V) to admit, confess
低估	dīgū	(V) to underestimate
和平	hépíng	(Vs/N) peaceful; peace
對策	duìcè	(N) countermeasure, strategy
販運	fànyùn	(N) trafficking, smuggling, transporting
首要之務	shǒuyào zhīwù	(Id) top/first priority, the most important issue
//當代中文/Book 5/L09-I		
核電廠	hédiànchǎng	(N) nuclear power plant
熱烈	rèliè	(Vs) fervent, ardent
乃至	nǎizhì	(Adv) and even
遠處	yuǎnchù	(N) a distant location
輻射	fúshè	(N) radiation
外洩	wàixiè	(Vi) to leak
爆炸	bàozhà	(Vp) to explode
危言聳聽	wéiyán sǒngtīng	(Id) alarmist talk, inflammatory statement
致命	zhìmìng	(Vs) lethal, fatal
退燒	tuìshāo	(Vp) to reduce fever, wane
行之有年	xíngzhī yǒunián	(Id) in use for years, long-established
三哩島	Sānlǐdǎo	(N) Three Mile Island, PA, USA
烏克蘭	Wūkèlán	(N) Ukraine
車諾比	Chēnuòbǐ	(N) Chernobyl
福島	Fúdǎo	(N) Fukushima
核災	hézāi	(N) nuclear disaster
核電	hédiàn	(N) nuclear power
列為	lièwéi	(Vst) to be ranked as, listed as
等級	děngjí	(N) level, grade
位於	wèiyú	(Vst) to be located at
海嘯	hǎixiào	(N) tsunami
洪水	hóngshuǐ	(N) flood
數百萬	shùbǎiwàn	(Ph) several millions, millions
及時	jíshí	(Adv) in time, in a timely manner
顆	kē	(M) measure for round objects, e.g., bombs
炸彈	zhàdàn	(N) bomb
立即	lìjí	(Adv) immediately, at once
令	lìng	(Vst) to cause, make, let
擔憂	dānyōu	(Vst) worried, concerned
歐洲癌症護理雜誌	Ōuzhōu Áizhèng Hùlǐ Zázhì	(N) European Journal of Cancer Care
數字	shùzì	(N) number, figures
周圍	zhōuwéi	(N) around, surrounding, on the periphery
罹癌	lí'ái'	(Vp) to be stricken with cancer
偏	piān	(Adv) slightly
青少年	qīngshàonián	(N) adolescents
細胞	xìbāo	(N) cell
製造	zhìzào	(V) to manufacture, produce, make
廢料	fèiliào	(N) waste, waste materials
可行	kěxíng	(Vs) feasible
偏遠	piānyuǎn	(Vs) rural, distant
任誰	rèn shéi	(Ph) anybody
因應	yīnyìng	(V) to deal with, handle
再生能源	zàishēng néngyuán	(Ph) renewable energy
妥善	tuǒshàn	(Adv) adequately, properly
頭痛	tóutòng	(Vs) a headache, a pain
無解	wújiě	(Vs) have no solution, be unsolvable
難題	nántí	(N) difficult problem, tough problem
正確	zhèngquè	(Vs) accurate
//當代中文/Book 5/L09-II		
環保	huánbǎo	(Vs) environmentally friendly
聯想	liánxiǎng	(Vi) to associate with in the mind, think of
事故	shìgù	(N) accident
運作	yùnzuò	(N) operation
疏失	shūshī	(N) negligence
視為	shìwéi	(Vst) to regard as
一概而論	yígài érlùn	(Id) to make sweeping generalizations
定時	dìngshí	(Vs-attr) to be fixed in time ( 定時炸彈 = time bomb)
風力	fēnglì	(N) wind power
水力	shuǐlì	(N) water power, hydropower
火力	huǒlì	(N) thermal power
太陽能	tàiyángnéng	(N) solar power
相比	xiāng bǐ	(Vi) to be compared to
機率	jīlǜ	(N) chance (of something happening), likelihood
雷	léi	(N) lightning
碳	tàn	(N) carbon
排放量	páifàngliàng	(N) emissions
有利	yǒulì	(Vs) beneficial to
二氧化碳	èryǎnghuàtàn	(N) carbon dioxide
溫室	wēnshì	(N) greenhouse
效應	xiàoyìng	(N) effect
河流	héliú	(N) river
魚類	yúlèi	(N) fish
噪音	zàoyīn	(N) noise
地熱	dìrè	(N) geothermal
成熟	chéngshóu	(Vp) mature
解決之道	jiějué zhīdào	(Id) solution
收取	shōuqǔ	(V) to charge, collect
高額	gāo'é'	(Vs-attr) high (amount of money, tariff, profit, etc.)
惹	rě	(V) to cause, provoke, incur, stir up
民怨	mínyuàn	(N) popular discontent, public anger
工業	gōngyè	(N) industry
停擺	tíngbǎi	(Vp) to stop, to come to a halt
倒退	dàotuì	(Vp) to reverse, regress
效率	xiàolǜ	(N) efficiency
供	gōng	(V) to supply
外商	wàishāng	(N) foreign company/businessman
優良	yōuliáng	(Vs) fine, excellent, good
民生	mínshēng	(N) people's well-being/livelihood'
效益	xiàoyì	(N) benefit
設備	shèbèi	(N) equipment
隱憂	yǐnyōu	(N) hidden concerns, worries
綠色	lǜsè	(N) green (color)
替代	tìdài	(V) alternative
//當代中文/Book 5/L10-I		
同性	tóngxìng	(Vs-attr) to be of the same gender
主播	zhǔbò	(N) newscaster, anchor
記者	jìzhě	(N) reporter, journalist, correspondent
連線	liánxiàn	(Vi) to be online with, be connected with
傳達	chuándá	(V) to convey
陣線	zhènxiàn	(N) ranks, front
發起	fāqǐ	(V) to initiate, launch, start
盡快	jìnkuài	(Adv) as soon/quickly as possible
同性戀	tóngxìngliàn	(N) homosexual, gay
異性戀	yìxìngliàn	(N) heterosexual, straight
相同	xiāngtóng	(Vs) identical
相愛	xiāng'ài'	(Vs) in love, to love each other
核心	héxīn	(N) core
伴侶	bànlǚ	(N) companion, mate, partner
無關	wúguān	(Vs) to have nothing to do with, be unrelated
打破	dǎpò	(V) to break, shatter
平權	píngquán	(N) equal rights
藉由	jièyóu	(Prep) through, by
節稅	jiéshuì	(Vi) to reduce, save on taxes
病危	bìngwéi	(Vs) critically ill
簽署	qiānshù	(V) to sign
文件	wénjiàn	(N) document
彼此	bǐcǐ	(N) each other, one another
親密	qīnmì	(Vs) intimate
伙伴	huǒbàn	(N) partner
陌生	mòshēng	(Vs) unacquainted, not mutually known
性病	xìngbìng	(N) sexually transmitted disease, STD
偏見	piānjiàn	(N) prejudice, bias
身上	shēnshàng	(N) himself, themselves
異性	yìxìng	(Vs-attr) opposite sex
有情人終成眷屬	yǒuqíngrén zhōngchéng juànshǔ	(Id) the lovers finally got married, every Jack has his Jill
末日	mòrì	(N) the end of the world
擴大	kuòdà	(V) to expand
範圍	fànwéi	(N) scope, range, extent
心聲	xīnshēng	(N) heartfelt wishes, aspirations
法案	fǎ'àn'	(N) bill, act
//當代中文/Book 5/L10-II		
鏡頭	jìngtóu	(N) lens, shot, scene
聯邦	liánbāng	(N) federal, federation, union
彩虹	cǎihóng	(N) rainbow
旗	qí	(N) flag, banner, standard
時刻	shíkè	(N) moment (in time)
駐外	zhùwài	(Vi) to be stationed abroad
歡慶	huānqìng	(V) to celebrate
擠進	jǐjìn	(Vpt) to crowd in, squeeze in
生物	shēngwù	(N) biology
本能	běnnéng	(N) instinct
繁衍	fányǎn	(V) to reproduce, propagate
尋找	xúnzhǎo	(V) to search for, seek
交配	jiāopèi	(Vi) to mate, copulate
法則	fǎzé	(N) law (natural, not legal laws)
定義	dìngyì	(N/V) definition; to define
互補	hùbǔ	(Vs) to complement each other
組合	zǔhé	(N/V) combination; to combine
全體	quántǐ	(N) as a whole, whole, entire, overall
詞彙	cíhuì	(N) word, term, vocabulary
稱呼	chēnghū	(V/N) to call; address, name
建構	jiàngòu	(V) to build, construct
革命	gémìng	(N/Vi) revolution; to have a revolution
做為	zuòwéi	(Vst) to serve as
無視	wúshì	(V) to disregard, defy
干涉	gānshè	(V) to interfere
邏輯	luójí	(N) logic
納入	nàrù	(V) to incorporate, include
第三者	dìsānzhě	(Ph) “third party” (i.e., the “other man/woman”)
原則	yuánzé	(N) principle
無異	wúyì	(Vs) not different from, the same as, tantamount to
形式	xíngshì	(N) form
亂倫	luànlún	(N) incest
不倫	bùlún	(N) immorality
白宮	Báigōng	(N) White House
巴黎鐵塔	Bālí Tiětǎ	(Ph) Eiffel Tower
打上	dǎshàng	(V) to shine up on
燈光	dēngguāng	(N) lights
不容忽視	bùróng hūshì	(Id) cannot ignore, should not be ignored
有賴	yǒulài	(Vst) to depend on, contingent on
各界	gèjiè	(N) all walks of life, the public
對話	duìhuà	(Vi) to engage in dialogues
激辯	jībiàn	(Vi) to engage in robust debate, wrangle
交還	jiāohuán	(V) to give back to, to return to
//當代中文/Book 6/L01-I
職校	zhíxiào	(N) speaking vocational school
//當代中文/Book 6/L01-II
//當代中文/Book 6/L02-I
//當代中文/Book 6/L02-II
//當代中文/Book 6/L03-I
//當代中文/Book 6/L03-II
//當代中文/Book 6/L04-I
//當代中文/Book 6/L04-II
//當代中文/Book 6/L05-I
//當代中文/Book 6/L05-II
//當代中文/Book 6/L06-I
//當代中文/Book 6/L06-II
//當代中文/Book 6/L07-I
//當代中文/Book 6/L07-II
//當代中文/Book 6/L08-I
//當代中文/Book 6/L08-II
